,driver_id,day_of_week,total_days,Hour,Minute,passenger_id,total_requests,total_assigned,avg_rating,completed_rides,ACR,status,ride_duration_hour,total_distance_covered_km,avg_fare,abandoned_trips,% completed_rides,canceled_rides
0,5397054,7,7,15,57,4186644,64,91,4.233333333,51,0.56043956,1,12.79361111,201.456,92.39215686,27,79.6875,13
1,5397002,7,7,2,38,5110289,45,268,4.0,27,0.100746269,1,7.2825,129.245,108.07407409999999,223,60.0,18
2,5396999,3,7,22,12,5161336,54,223,4.3888888889999995,40,0.17937219699999998,1,9.922777778,185.12599999999998,105.6,169,74.07407407407408,14
3,5396817,2,7,18,38,3043378,33,121,4.5,19,0.157024793,1,5.076111111,73.232,90.36842105,88,57.57575757575758,14
4,5396502,5,7,19,38,4750805,65,196,4.608695652,42,0.214285714,1,9.806944443999999,209.125,112.16666670000001,131,64.61538461538461,23
5,5396394,3,7,18,31,4430356,53,147,4.125,24,0.163265306,1,4.109722222,75.89,86.20833333,94,45.28301886792453,29
6,5395735,4,7,18,52,4360017,79,179,4.242424242,60,0.335195531,1,13.19611111,257.399,99.51666667,100,75.9493670886076,19
7,5395399,6,7,19,9,4088833,54,489,4.0869565219999995,43,0.08793456,1,10.63916667,210.979,107.04651159999999,435,79.62962962962963,11
8,5395221,5,7,18,4,4839448,96,169,4.5,64,0.378698225,1,12.07111111,270.988,101.0,73,66.66666666666666,32
9,5389204,5,7,19,8,4847721,67,125,4.16,49,0.392,1,15.07722222,235.674,104.57142859999999,58,73.13432835820896,18
10,5387467,3,7,18,35,4941298,38,69,4.714285714,23,0.333333333,1,6.360555556,107.991,104.78260870000001,31,60.526315789473685,15
11,5387445,1,7,8,42,4114634,24,55,4.1,19,0.345454545,1,4.143611111,88.189,103.52631579999999,31,79.16666666666666,5
12,5383463,3,7,16,25,5219975,85,287,4.558823529,61,0.212543554,1,19.865,315.785,111.96721310000001,202,71.76470588235294,24
13,5383435,3,7,6,14,5402795,47,178,4.3888888889999995,39,0.21910112399999998,1,9.925833333,219.095,120.43589740000002,131,82.97872340425532,8
14,5375397,5,7,6,38,4302638,72,151,4.24,45,0.298013245,1,8.786111111,196.889,100.33333329999999,79,62.5,27
15,5374025,7,7,11,22,4884079,59,88,4.1071428569999995,49,0.556818182,1,11.81916667,234.766,109.6326531,29,83.05084745762711,10
16,5373614,1,7,13,37,5233005,106,136,4.483870968,75,0.5514705879999999,1,17.89944444,322.231,98.68,30,70.75471698113208,31
17,5373224,7,7,15,3,5010821,47,141,4.0,39,0.276595745,1,8.148333333,136.69799999999998,91.46153846,94,82.97872340425532,8
18,5373102,1,7,8,24,5085051,33,89,3.833333333,22,0.24719101100000002,1,5.663055556000001,103.605,103.2727273,56,66.66666666666666,11
19,5369098,3,7,18,37,3758308,132,305,4.465116279,107,0.350819672,1,27.58805556,523.009,106.32710279999999,173,81.06060606060606,25
20,5368344,6,7,12,49,4390422,49,275,4.428571429,14,0.050909091,1,3.4044444439999997,55.575,93.21428571,226,28.57142857142857,35
21,5368278,4,7,17,40,5340236,148,190,4.396226415,108,0.568421053,1,27.07361111,411.56699999999995,91.60185185,42,72.97297297297297,40
22,5367878,2,7,19,11,4523117,103,307,4.3611111110000005,72,0.23452768699999998,1,20.56611111,355.82599999999996,105.29166670000001,204,69.90291262135922,31
23,5366602,4,7,17,3,4692300,156,321,4.043478261000001,49,0.152647975,1,15.33888889,290.254,124.2653061,165,31.41025641025641,107
24,5365784,7,7,22,31,4518841,43,131,4.8125,33,0.251908397,1,7.506388889,153.346,108.2727273,88,76.74418604651163,10
25,5363152,1,7,6,13,4261382,75,163,3.9411764710000003,39,0.239263804,1,9.226666667,160.017,95.94871795,88,52.0,36
26,5362388,2,7,22,18,4787798,76,146,4.1,42,0.287671233,1,9.688333333,186.668,105.5238095,70,55.26315789473685,34
27,5362334,3,7,8,41,4760203,67,85,4.310344828,50,0.588235294,1,14.22916667,246.81900000000002,107.54,18,74.6268656716418,17
28,5362332,3,7,19,51,4754280,117,493,4.25,40,0.081135903,1,8.324166667,146.132,88.725,376,34.18803418803419,77
29,5361511,2,7,10,51,4511491,157,284,4.2452830189999995,106,0.373239437,1,20.39944444,341.17900000000003,83.86792453,127,67.51592356687898,51
30,5361023,3,7,19,21,5371073,119,233,4.52173913,82,0.35193133,1,17.16805556,320.635,94.74390244,114,68.90756302521008,37
31,5360601,1,7,14,27,4985233,159,284,4.087719298000001,107,0.376760563,1,27.44416667,450.096,96.11214953,125,67.29559748427673,52
32,5360289,6,7,13,21,4091274,177,277,4.022222222,101,0.364620939,1,22.53666667,423.051,105.2574257,100,57.06214689265536,76
33,5360251,1,7,9,14,4066927,85,107,4.3636363639999995,61,0.570093458,1,16.81111111,302.848,107.4098361,22,71.76470588235294,24
34,5359946,6,7,18,44,5397764,48,130,4.285714286,23,0.17692307699999998,1,5.531388889,115.02600000000001,109.2608696,82,47.91666666666667,25
35,5359891,6,7,21,42,5265985,44,81,3.785714286,33,0.40740740700000005,1,8.106666667,155.947,104.30303029999999,37,75.0,11
36,5358553,1,7,18,45,4299882,85,190,4.185185185,70,0.36842105299999994,1,18.04027778,316.459,101.2285714,105,82.35294117647058,15
37,5357817,2,7,11,46,5394139,39,63,4.421052632,30,0.47619047600000003,1,8.003888889,152.819,110.6,24,76.92307692307693,9
38,5355491,2,7,10,19,5397764,86,154,3.5,25,0.162337662,1,7.222222222,107.325,98.8,68,29.069767441860467,61
39,5355430,5,7,0,37,4943799,65,168,4.307692308,45,0.267857143,1,10.34555556,230.49599999999998,126.17777779999999,103,69.23076923076923,20
40,5355294,2,7,22,13,5350374,99,295,4.4375,55,0.186440678,1,14.01111111,284.72700000000003,115.87272730000001,196,55.55555555555556,44
41,5354572,6,7,20,10,4963823,53,311,4.3,21,0.067524116,1,9.041388889,122.493,122.6190476,258,39.62264150943396,32
42,5354034,7,7,13,30,3274972,71,107,4.307692308,58,0.542056075,1,11.9325,222.577,94.27586207,36,81.69014084507043,13
43,5352906,7,7,6,53,3773942,60,525,4.0,40,0.076190476,1,10.57611111,208.12599999999998,112.85,465,66.66666666666666,20
44,5352897,4,7,17,21,4622228,95,149,4.214285714,70,0.469798658,1,14.83222222,234.801,82.65714286,54,73.68421052631578,25
45,5350817,7,7,13,14,4836962,64,142,4.409090909,42,0.29577464800000003,1,11.95277778,209.532,107.547619,78,65.625,22
46,5348826,1,7,11,24,3253157,132,197,4.454545455,81,0.411167513,1,18.65805556,363.842,102.33333329999999,65,61.36363636363637,51
47,5348756,7,7,22,35,5420413,59,288,4.777777778,25,0.08680555599999999,1,4.320277778,104.837,105.56,229,42.3728813559322,34
48,5348427,3,7,17,44,5241047,73,267,4.0,48,0.179775281,1,13.59,190.476,93.5,194,65.75342465753424,25
49,5347366,3,7,13,40,5365507,62,202,4.315789474,36,0.178217822,1,8.835555556000001,158.404,99.52777778,140,58.06451612903226,26
50,5346839,5,7,8,39,3791349,72,169,4.35483871,63,0.372781065,1,17.38277778,305.86,104.41269840000001,97,87.5,9
51,5346148,1,7,20,37,5228470,171,340,3.7735849060000004,93,0.27352941199999997,1,26.94194444,520.477,117.5376344,169,54.385964912280706,78
52,5346014,7,7,9,13,3875399,127,185,4.428571429,81,0.437837838,1,21.04611111,366.125,100.85185190000001,58,63.77952755905512,46
53,5341175,6,7,22,11,3671952,60,232,4.434782609,51,0.21982758600000002,1,11.65944444,248.91400000000002,108.96078429999999,172,85.0,9
54,5339230,5,7,21,59,5427883,41,95,4.266666667,30,0.31578947399999996,1,7.221944444,148.453,114.36666670000001,54,73.17073170731707,11
55,5334077,3,7,18,4,4672104,76,208,4.555555556,20,0.096153846,1,4.242777778,71.77199999999999,85.9,132,26.31578947368421,56
56,5333905,7,7,20,5,4825466,82,175,4.15,41,0.23428571399999998,1,8.454166667,184.63,100.48780490000001,93,50.0,41
57,5332908,4,7,11,58,4716791,81,669,4.466666667,37,0.055306428,1,8.373611111,135.64600000000002,86.18918919,588,45.67901234567901,44
58,5328213,4,7,19,40,3782706,30,32,4.0,23,0.71875,1,4.255,84.135,91.26086957,2,76.66666666666667,7
59,5327093,4,7,18,20,4334833,29,132,3.875,15,0.113636364,1,2.536666667,42.52,77.06666667,103,51.724137931034484,14
60,5326464,2,7,7,9,4001280,86,122,4.454545455,60,0.491803279,1,12.81166667,270.135,100.1166667,36,69.76744186046511,26
61,5324522,5,7,17,26,4187981,130,191,4.375,89,0.465968586,1,27.43472222,438.336,108.67415729999999,61,68.46153846153847,41
62,5323813,7,7,14,54,3670044,86,167,4.1,29,0.173652695,1,5.398055556,125.779,98.13793103,81,33.72093023255814,57
63,5319842,4,7,21,35,3941715,47,176,4.666666667,24,0.13636363599999998,1,7.720555556,136.438,123.66666670000001,129,51.06382978723404,23
64,5319829,2,7,18,58,5406402,52,130,3.8636363639999995,29,0.223076923,1,8.467777778,147.384,108.34482759999999,78,55.769230769230774,23
65,5318906,4,7,10,10,3899726,57,253,3.866666667,31,0.12252964400000001,1,6.170277777999999,93.63,77.35483871,196,54.385964912280706,26
66,5317456,4,7,12,28,4147899,65,131,4.5,40,0.305343511,1,10.97333333,184.53900000000002,105.55,66,61.53846153846154,25
67,5317375,1,7,10,10,5243025,76,143,4.193548387,63,0.440559441,1,17.72194444,287.41200000000003,102.2539683,67,82.89473684210526,13
68,5317240,2,7,19,31,5406795,49,96,4.2,31,0.322916667,1,8.022222222,139.474,99.80645161,47,63.26530612244898,18
69,5316975,2,7,10,53,4497671,135,300,3.96,52,0.173333333,1,8.999444444,150.58700000000002,77.40384615,165,38.51851851851852,83
70,5312094,5,7,18,1,5428022,50,120,4.470588235,26,0.21666666699999998,1,8.144722222,159.128,126.9615385,70,52.0,24
71,5311075,7,7,16,6,4154100,225,653,4.333333333,42,0.06431853,1,2.888888889,57.363,59.45238095,428,18.666666666666668,183
72,5311003,2,7,20,11,4385119,35,66,4.307692308,30,0.454545455,1,8.660277778,143.711,106.43333329999999,31,85.71428571428571,5
73,5311001,1,7,10,11,4656968,124,225,4.090909091,44,0.19555555600000002,1,14.94027778,244.518,123.79545449999999,101,35.483870967741936,80
74,5310952,2,7,8,49,3794625,59,116,4.214285714,29,0.25,1,11.00194444,165.574,121.1034483,57,49.152542372881356,30
75,5310502,2,7,17,17,3908218,75,107,4.4375,37,0.345794393,1,8.305,171.104,110.8108108,32,49.333333333333336,38
76,5309384,6,7,22,11,4095056,41,357,3.666666667,14,0.039215686,1,1.94,53.343,97.42857143,316,34.146341463414636,27
77,5309242,5,7,14,29,5331782,180,317,4.366666667,71,0.22397476300000002,1,21.35861111,373.19699999999995,111.6197183,137,39.44444444444444,109
78,5306125,5,7,13,5,4059703,40,132,4.055555556,33,0.25,1,6.229166667,99.978,77.21212121,92,82.5,7
79,5305088,7,7,17,6,4310621,136,192,4.260869565,83,0.43229166700000005,1,20.43027778,379.994,104.50602409999999,56,61.029411764705884,53
80,5304619,5,7,17,3,4873171,44,63,4.666666667,7,0.111111111,1,2.505277778,39.421,113.0,19,15.909090909090908,37
81,5303157,1,7,2,8,4035417,111,293,4.333333333,39,0.133105802,1,2.6919444439999998,65.506,75.66666667,182,35.13513513513514,72
82,5302420,4,7,9,8,4660215,61,174,4.3571428569999995,32,0.18390804600000002,1,9.846388889,178.949,117.8125,113,52.459016393442624,29
83,5302183,5,7,18,19,5068974,138,474,4.65625,62,0.130801688,1,14.36055556,241.253,92.12903226,336,44.927536231884055,76
84,5297921,1,7,9,10,4180408,96,151,4.409090909,43,0.28476821199999997,1,8.83,162.192,89.6744186,55,44.79166666666667,53
85,5297310,4,7,19,28,5307171,82,130,4.310344828,56,0.43076923100000003,1,14.83138889,286.059,111.2678571,48,68.29268292682927,26
86,5296776,4,7,18,10,3581960,105,141,4.596153846,92,0.65248227,1,27.08222222,493.505,114.27173909999998,36,87.61904761904762,13
87,5296585,1,7,12,16,4522402,151,213,4.276595745,94,0.44131455399999997,1,21.34777778,399.228,96.0212766,62,62.251655629139066,57
88,5295948,1,7,13,13,4079618,72,149,4.1,32,0.214765101,1,9.785555556,173.54,112.90625,77,44.44444444444444,40
89,5295754,1,7,15,19,3886603,68,339,4.434782609,43,0.126843658,1,0.034444444,28.395,51.30232558,271,63.23529411764706,25
90,5294513,7,7,19,16,5426738,41,224,4.571428571,24,0.107142857,1,5.784444444,98.634,92.54166667,183,58.536585365853654,17
91,5289967,5,7,21,59,3761321,141,254,4.222222222,37,0.145669291,1,10.11,178.717,108.7027027,113,26.24113475177305,104
92,5289561,6,7,19,4,4303549,107,361,4.3125,71,0.19667590000000001,1,15.38916667,253.96200000000002,86.32394366,254,66.35514018691589,36
93,5289364,7,7,23,0,4824497,125,475,4.326086957,91,0.191578947,1,24.10611111,523.371,128.4945055,350,72.8,34
94,5285902,7,7,6,40,3974376,81,155,4.222222222,33,0.21290322600000003,1,9.478333333,159.21200000000002,105.87878789999999,74,40.74074074074074,48
95,5285826,6,7,14,4,4788892,41,295,3.4444444439999997,19,0.06440678,1,5.134722222,75.597,92.42105263,254,46.34146341463415,22
96,5276173,7,7,12,29,3827317,41,232,4.529411765,29,0.125,1,7.5147222220000005,136.735,106.0,191,70.73170731707317,12
97,5273459,5,7,8,15,5092901,42,126,4.285714286,30,0.23809523800000001,1,7.455833332999999,140.658,106.33333329999999,84,71.42857142857143,12
98,5273061,7,7,3,29,4613390,83,173,4.166666667,29,0.167630058,1,4.95,98.859,92.65517241,90,34.93975903614458,54
99,5264376,2,7,12,2,5298578,136,216,4.0,92,0.425925926,1,18.29472222,357.415,96.52173913,80,67.64705882352942,44
100,5264240,3,7,18,58,3933959,56,86,4.666666667,41,0.476744186,1,9.098055556,179.937,100.6097561,30,73.21428571428571,15
101,5256496,3,7,19,35,4661882,24,102,4.333333333,9,0.088235294,1,0.080277778,31.3,83.77777778,78,37.5,15
102,5255479,6,7,7,17,4660564,169,248,4.3859649119999995,121,0.487903226,1,33.88888889,620.066,109.9586777,79,71.59763313609467,48
103,5250030,5,7,17,37,4776168,56,425,4.0,23,0.054117647000000005,1,5.795833332999999,96.67200000000001,95.91304348,369,41.07142857142857,33
104,5249531,5,7,17,20,5407322,83,252,4.185185185,48,0.19047619,1,3.3444444439999996,144.709,82.0625,169,57.831325301204814,35
105,5239873,6,7,16,14,4645018,32,260,4.666666667,13,0.05,1,3.192777778,48.474,92.15384615,228,40.625,19
106,5233854,1,7,17,47,4671820,46,71,4.65,36,0.507042254,1,7.146388889,158.556,99.19444444,25,78.26086956521739,10
107,5228217,4,7,16,31,4762783,74,193,4.266666667,27,0.13989637300000002,1,0.18583333300000002,53.674,66.33333333,119,36.486486486486484,47
108,5226694,7,7,4,8,5204165,61,130,4.695652174,45,0.346153846,1,11.78388889,236.00400000000002,112.1111111,69,73.77049180327869,16
109,5225414,4,7,19,50,3041474,30,211,3.666666667,13,0.061611374000000003,1,2.7338888889999997,59.049,102.1538462,181,43.333333333333336,17
110,5225384,2,7,19,27,5143254,97,342,4.0,44,0.128654971,1,8.740277778,142.274,82.52272727,245,45.36082474226804,53
111,5225058,5,7,13,24,3782543,85,156,4.259259258999999,60,0.384615385,1,13.28861111,274.051,102.2666667,71,70.58823529411765,25
112,5221083,3,7,6,17,5306069,174,261,3.977777778,114,0.43678160899999996,1,31.0625,549.606,105.4035088,87,65.51724137931035,60
113,5220164,5,7,11,24,4864725,55,103,4.19047619,40,0.388349515,1,10.99,192.768,107.775,48,72.72727272727273,15
114,5217691,2,7,19,27,4192767,127,183,4.447368421,80,0.43715847,1,22.48861111,426.165,118.1625,56,62.99212598425197,47
115,5213377,1,7,12,45,4039987,100,205,4.421052632,71,0.34634146299999996,1,21.11777778,398.764,116.8732394,105,71.0,29
116,5212182,1,7,11,24,3049246,147,257,4.1578947369999995,76,0.295719844,1,12.60694444,223.84099999999998,78.48684211,110,51.70068027210885,71
117,5210834,4,7,20,6,5196596,56,312,3.791666667,41,0.131410256,1,9.218888889,169.525,98.02439024,256,73.21428571428571,15
118,5206192,5,7,22,22,5040844,135,146,4.536585366000001,96,0.6575342470000001,1,21.1025,433.839,107.32291670000001,11,71.11111111111111,39
119,5204269,3,7,12,39,4827732,96,231,4.464285714,55,0.23809523800000001,1,10.84916667,156.539,78.32727273,135,57.291666666666664,41
120,5204223,1,7,11,21,3829789,61,133,4.083333333,30,0.22556391,1,10.81,165.38,116.5,72,49.18032786885246,31
121,5196817,2,7,11,17,5018105,61,195,4.47826087,46,0.23589743600000002,1,14.80055556,254.342,117.19565220000001,134,75.40983606557377,15
122,5195392,4,7,22,8,4835714,45,67,4.538461538,29,0.432835821,1,6.943333332999999,144.79399999999998,121.7586207,22,64.44444444444444,16
123,5180816,7,7,21,48,5442549,50,211,4.222222222,37,0.17535545,1,4.327777778,132.018,91.62162162,161,74.0,13
124,5180169,6,7,19,29,5304200,36,88,4.333333333,26,0.295454545,1,5.365,119.927,108.7692308,52,72.22222222222221,10
125,5179599,4,7,23,24,5383786,58,100,4.75,45,0.45,1,14.98472222,246.68599999999998,124.64444440000001,42,77.58620689655173,13
126,5174524,2,7,13,38,4118280,104,148,4.484848485,76,0.513513514,1,18.17611111,350.06,101.86842109999999,44,73.07692307692307,28
127,5173801,2,7,11,39,4824768,111,225,3.833333333,39,0.173333333,1,8.135277777999999,150.548,93.71794872,114,35.13513513513514,72
128,5170700,1,7,15,16,4389825,38,163,3.8181818180000002,21,0.12883435599999998,1,5.585,97.671,104.80952380000001,125,55.26315789473685,17
129,5169920,7,7,18,31,4666717,69,106,4.321428571,51,0.481132075,1,12.90361111,220.845,99.88235294,37,73.91304347826086,18
130,5169018,3,7,21,50,4087032,48,59,4.583333333,21,0.35593220299999995,1,3.769166667,81.044,96.14285714,11,43.75,27
131,5166152,2,7,10,42,4868477,163,244,4.020408163,107,0.43852459,1,29.53,516.779,106.2616822,81,65.6441717791411,56
132,5165911,2,7,16,37,4267280,35,75,4.666666667,27,0.36,1,8.600555556,132.07,105.8888889,40,77.14285714285715,8
133,5165267,1,7,15,18,3641183,102,142,4.033333333,63,0.443661972,1,19.57361111,307.439,106.5238095,40,61.76470588235294,39
134,5164950,5,7,18,2,4565094,83,121,3.961538462,67,0.553719008,1,15.63111111,267.473,92.98507463,38,80.72289156626506,16
135,5164805,2,7,8,44,3815567,88,101,4.277777778,35,0.34653465299999997,1,9.920555556,171.483,105.62857140000001,13,39.77272727272727,53
136,5164670,7,7,14,36,5030827,79,93,3.789473684,47,0.505376344,1,11.30166667,165.69400000000002,85.08510638,14,59.49367088607595,32
137,5159884,1,7,9,24,4262887,58,145,4.4,26,0.179310345,1,7.063055556,140.18,115.57692309999999,87,44.827586206896555,32
138,5159744,3,7,19,5,3543112,129,308,4.266666667,72,0.233766234,1,19.78805556,315.57099999999997,98.41666667,179,55.81395348837209,57
139,5159663,4,7,18,30,4696263,50,94,4.25,34,0.36170212799999996,1,9.040277778,153.937,99.35294118,44,68.0,16
140,5159306,1,7,6,39,5240532,101,115,4.051282051,69,0.6,1,17.46222222,336.167,105.7391304,14,68.31683168316832,32
141,5157604,2,7,10,59,5245741,109,274,4.295454545,88,0.321167883,1,19.7925,397.523,104.1477273,165,80.73394495412845,21
142,5145138,7,7,7,12,4255488,81,148,4.260869565,53,0.358108108,1,14.2175,230.43099999999998,100.245283,67,65.4320987654321,28
143,5141340,7,7,20,45,4934326,89,106,4.578947368,71,0.669811321,1,17.66055556,331.478,105.76056340000001,17,79.7752808988764,18
144,5138154,5,7,20,22,5265636,139,308,4.615384615,101,0.327922078,1,26.55944444,532.316,113.47524750000001,169,72.66187050359713,38
145,5122519,1,7,19,6,4589066,79,211,4.333333333,9,0.042654028,1,3.566111111,54.1,123.44444440000001,132,11.39240506329114,70
146,5116282,3,7,9,15,5019147,107,291,4.137931034,55,0.18900343600000002,1,11.01722222,200.47400000000002,88.65454545,184,51.4018691588785,52
147,5115303,3,7,8,57,3704722,94,271,4.352941176,63,0.232472325,1,14.04194444,262.882,98.63492063,177,67.02127659574468,31
148,5106509,2,7,18,14,4038756,89,192,4.242424242,69,0.359375,1,17.7725,251.67700000000002,87.68115942,103,77.52808988764045,20
149,5106446,4,7,22,38,4329103,84,166,4.0,60,0.36144578299999996,1,13.2325,266.81,102.7666667,82,71.42857142857143,24
150,5092814,5,7,19,28,4540481,57,268,4.318181818,35,0.130597015,1,7.676944444,108.801,81.11428571,211,61.40350877192983,22
151,5083506,2,7,6,22,5170652,43,224,4.875,19,0.084821429,1,4.289722222,92.46799999999999,110.0,181,44.18604651162791,24
152,5083156,2,7,11,36,4673622,67,265,3.933333333,36,0.135849057,1,7.500277777999999,128.247,88.5,198,53.73134328358209,31
153,5082585,1,7,15,51,3528698,85,154,4.533333333,52,0.33766233799999995,1,15.18138889,246.873,105.1923077,69,61.1764705882353,33
154,5080101,2,7,22,37,4861095,40,213,4.5,20,0.093896714,1,5.813888888999999,122.51899999999999,128.0,173,50.0,20
155,5076437,7,7,18,22,4692966,30,86,4.3636363639999995,21,0.244186047,1,5.2775,95.01700000000001,100.4761905,56,70.0,9
156,5074922,4,7,9,13,4424034,73,143,3.722222222,42,0.293706294,1,11.175,183.299,98.95238095,70,57.534246575342465,31
157,5074296,6,7,14,37,3645289,96,165,4.266666667,61,0.36969697,1,16.605,232.33599999999998,89.91803279,69,63.541666666666664,35
158,5071387,6,7,6,50,3837935,89,417,4.176470588,69,0.165467626,1,14.98305556,252.551,88.07246377,328,77.52808988764045,20
159,5068200,7,7,19,49,4547630,70,201,4.2352941180000006,31,0.154228856,1,6.083333333,101.985,85.87096774,131,44.285714285714285,39
160,5067585,2,7,17,43,3601053,128,213,4.333333333,88,0.41314554,1,21.5875,426.57099999999997,108.6363636,85,68.75,40
161,5066010,3,7,10,45,5390372,139,171,4.3389830510000005,112,0.65497076,1,33.71416667,546.2819999999999,107.7857143,32,80.57553956834532,27
162,5058733,6,7,7,46,3933369,72,183,4.34375,55,0.300546448,1,11.13416667,235.55700000000002,96.69090909,111,76.38888888888889,17
163,5053389,5,7,16,16,3709890,132,148,4.125,107,0.722972973,1,28.59833333,534.626,120.42056070000001,16,81.06060606060606,25
164,5053111,3,7,11,6,5366565,86,181,3.633333333,53,0.29281768,1,21.60222222,327.145,127.56603770000001,95,61.627906976744185,33
165,5052985,1,7,7,39,3908966,77,138,4.535714286,45,0.326086957,1,14.67888889,223.295,108.0,61,58.44155844155844,32
166,5052981,2,7,11,18,3764320,118,193,4.2380952380000005,97,0.502590674,1,25.5225,448.255,103.185567,75,82.20338983050848,21
167,5051181,6,7,0,24,5428208,86,155,4.34375,66,0.42580645200000006,1,14.99472222,360.99199999999996,159.5454545,69,76.74418604651163,20
168,5049683,6,7,19,32,3906008,57,134,4.24137931,49,0.365671642,1,11.49111111,274.959,124.81632649999999,77,85.96491228070175,8
169,5036894,3,7,20,7,4701953,35,69,3.75,29,0.420289855,1,5.789166667000001,124.51299999999999,97.68965517,34,82.85714285714286,6
170,5033182,1,7,19,46,4391568,45,108,4.6363636360000005,26,0.240740741,1,5.2586111110000004,132.13,122.07692309999999,63,57.77777777777777,19
171,5032504,7,7,16,21,3661085,80,166,3.6956521739999997,43,0.259036145,1,0.028055556000000002,189.243,101.53488370000001,86,53.75,37
172,5020759,4,7,21,11,4460810,50,78,4.777777778,41,0.5256410260000001,1,8.192777778,187.86,113.12195120000001,28,82.0,9
173,5019177,2,7,6,15,4193790,52,217,4.625,27,0.12442396300000001,1,6.8266666670000005,141.635,111.85185190000001,165,51.92307692307693,25
174,5017599,6,7,8,50,4933178,149,188,4.26,110,0.585106383,1,26.04944444,470.434,100.4,39,73.8255033557047,39
175,5017499,3,7,7,23,4828571,56,203,4.538461538,43,0.21182266,1,20.76583333,186.683,99.88372093,147,76.78571428571429,13
176,5016041,2,7,18,1,4322171,87,126,4.652173913,54,0.428571429,1,12.17916667,210.574,90.42592593,39,62.06896551724138,33
177,5012278,3,7,11,53,5409135,76,171,4.272727273,49,0.286549708,1,16.15611111,244.822,108.61224490000001,95,64.47368421052632,27
178,5012205,2,7,15,49,3253320,54,178,4.473684211,32,0.179775281,1,9.685833333,146.0,100.25,124,59.25925925925925,22
179,5011402,5,7,7,37,4759851,38,147,4.4,16,0.10884353699999999,1,3.652777778,69.866,99.9375,109,42.10526315789473,22
180,5011029,5,7,9,39,4950226,94,189,4.125,70,0.37037037,1,15.93111111,298.815,98.18571429,95,74.46808510638297,24
181,5004204,2,7,20,58,4898813,51,64,4.6,26,0.40625,1,5.9344444439999995,128.92,127.0384615,13,50.98039215686274,25
182,4984455,2,7,22,38,4851225,90,147,4.36,62,0.421768707,1,16.72194444,327.88,112.983871,57,68.88888888888889,28
183,4980869,1,7,19,19,4468949,79,247,4.533333333,56,0.226720648,1,18.10222222,321.418,120.1071429,168,70.88607594936708,23
184,4980010,1,7,17,4,4620917,62,101,4.3125,32,0.31683168300000003,1,4.013611111,89.762,77.8125,39,51.61290322580645,30
185,4971773,3,7,15,57,4852044,107,229,4.2647058819999994,71,0.310043668,1,16.82222222,286.878,97.77464789,122,66.35514018691589,36
186,4970994,6,7,12,33,4046508,88,236,4.3142857139999995,70,0.296610169,1,14.79777778,256.987,90.27142857,148,79.54545454545455,18
187,4970854,7,7,13,34,3243210,65,97,4.285714286,42,0.432989691,1,8.836944444,164.06,90.38095238,32,64.61538461538461,23
188,4970770,1,7,20,15,4870059,70,202,4.076923077,41,0.202970297,1,21.41805556,223.69099999999997,117.5609756,132,58.57142857142858,29
189,4965310,1,7,11,2,3958977,88,196,4.583333333,54,0.275510204,1,12.91777778,245.28599999999997,106.31481480000001,108,61.36363636363637,34
190,4964811,1,7,13,58,4768847,47,93,4.5,34,0.36559139799999996,1,8.022777778,148.881,100.17647059999999,46,72.3404255319149,13
191,4950821,2,7,15,0,5402404,101,139,4.166666667,65,0.467625899,1,19.80888889,338.404,110.4769231,38,64.35643564356435,36
192,4934638,2,7,19,55,5339181,63,125,4.35,48,0.384,1,11.60388889,214.638,100.22916670000001,62,76.19047619047619,15
193,4933357,6,7,14,45,3043003,31,59,4.466666667,28,0.474576271,1,6.935277778,145.734,110.67857140000001,28,90.32258064516128,3
194,4933336,1,7,13,55,5161726,65,116,4.263157895,55,0.474137931,1,14.9525,271.328,109.9454545,51,84.61538461538461,10
195,4922405,2,7,21,42,5292571,93,228,4.4,43,0.188596491,1,11.57861111,241.873,137.744186,135,46.236559139784944,50
196,4921056,2,7,12,37,4514169,81,379,4.1,46,0.12137203199999999,1,14.63638889,272.332,125.32608700000002,298,56.79012345679012,35
197,4919968,4,7,17,21,3491138,107,261,4.451612903,85,0.32567049800000003,1,25.15694444,389.346,109.4470588,154,79.43925233644859,22
198,4917065,4,7,8,28,4617856,81,181,4.208333333,47,0.259668508,1,11.00611111,207.335,99.82978723,100,58.0246913580247,34
199,4911391,6,7,12,2,4906638,91,343,4.5,72,0.209912536,1,20.23555556,277.534,91.58333333,252,79.12087912087912,19
200,4894765,4,7,9,31,4697722,129,352,4.135135135,75,0.213068182,1,19.19361111,376.017,108.68,223,58.139534883720934,54
201,4888253,2,7,17,54,4535594,116,290,4.1,69,0.23793103399999999,1,17.53194444,325.51099999999997,105.7681159,174,59.48275862068966,47
202,4887973,4,7,13,41,5018600,16,329,5.0,3,0.009118540999999999,1,1.227222222,18.678,130.3333333,313,18.75,13
203,4881593,1,7,6,12,4624129,92,136,4.242424242,64,0.470588235,1,20.24222222,322.874,106.390625,44,69.56521739130434,28
204,4879521,7,7,20,34,3234520,79,146,4.1,52,0.356164384,1,9.2225,190.248,89.19230769,67,65.82278481012658,27
205,4868071,1,7,10,49,5203749,70,179,4.4,31,0.173184358,1,8.484722222,181.503,123.5483871,109,44.285714285714285,39
206,4858452,7,7,21,51,5045776,36,56,4.266666667,26,0.46428571399999996,1,4.738333333,136.9,128.0384615,20,72.22222222222221,10
207,4853197,1,7,19,19,5373192,17,295,4.0,6,0.020338983,1,3.3086111110000003,49.3,159.16666669999998,278,35.294117647058826,11
208,4851117,3,7,19,20,3686268,84,160,4.36,55,0.34375,1,4.624722222,109.75299999999999,63.85454545,76,65.47619047619048,29
209,4846036,3,7,17,40,4827975,88,153,4.15625,67,0.437908497,1,15.48222222,279.01599999999996,97.56716418,65,76.13636363636364,21
210,4845880,4,7,20,20,4138133,53,80,3.375,26,0.325,1,4.7066666669999995,98.57,91.53846154,27,49.056603773584904,27
211,4843473,4,7,18,43,5165194,46,117,4.0,3,0.025641026,1,0.721944444,12.194,96.33333333,71,6.521739130434782,43
212,4840058,3,7,11,52,4295589,58,141,4.608695652,46,0.326241135,1,13.6675,240.012,112.2391304,83,79.3103448275862,12
213,4833154,3,7,23,7,5076732,68,126,4.210526316,41,0.325396825,1,8.495833333,196.44799999999998,138.68292680000002,58,60.29411764705882,27
214,4810452,7,7,17,40,4257870,69,118,4.333333333,55,0.466101695,1,14.14277778,267.592,108.2181818,49,79.71014492753623,14
215,4805437,7,7,3,23,3276578,44,140,4.1428571430000005,14,0.1,1,2.5122222219999997,58.327,128.8571429,96,31.818181818181817,30
216,4791202,2,7,10,2,5402174,93,164,4.4,60,0.365853659,1,21.41472222,313.34,111.81666670000001,71,64.51612903225806,33
217,4780254,4,7,16,15,4304917,60,86,4.454545455,46,0.534883721,1,11.56416667,179.475,91.41304348,26,76.66666666666667,14
218,4776928,5,7,6,39,5313234,67,104,4.173913043,39,0.375,1,11.20638889,206.278,114.2820513,37,58.2089552238806,28
219,4759874,4,7,13,1,4892205,82,193,4.473684211,54,0.27979274600000004,1,14.3775,260.83799999999997,107.5925926,111,65.85365853658537,28
220,4751686,7,7,16,53,4555930,100,200,4.517241379,63,0.315,1,16.35,274.60900000000004,98.01587302,100,63.0,37
221,4737163,7,7,17,31,5399144,53,105,4.416666667,15,0.14285714300000002,1,2.531944444,52.575,82.86666667,52,28.30188679245283,38
222,4736049,3,7,12,19,5331472,35,143,4.777777778,20,0.13986014,1,5.744166667000001,112.60600000000001,120.45,108,57.14285714285714,15
223,4735867,2,7,10,21,4813295,79,259,4.153846154,46,0.177606178,1,13.91194444,300.406,138.41304350000001,180,58.22784810126582,33
224,4735855,1,7,18,58,3043821,73,244,4.25,57,0.233606557,1,16.05305556,345.171,127.87719299999999,171,78.08219178082192,16
225,4728671,7,7,22,27,3262669,47,111,4.1363636360000005,41,0.369369369,1,9.526111111,213.31599999999997,121.6097561,64,87.2340425531915,6
226,4705535,7,7,9,27,5364861,71,610,4.066666667,29,0.047540984,1,6.674722222000001,106.686,89.10344828,539,40.845070422535215,42
227,4698655,7,7,19,31,5092840,65,123,4.25,31,0.25203252,1,7.994444444,159.14700000000002,126.09677420000001,58,47.69230769230769,34
228,4693119,1,7,16,26,4073460,75,123,4.517241379,50,0.406504065,1,11.135,182.356,87.74,48,66.66666666666666,25
229,4679813,4,7,20,31,3715729,37,168,4.307563701,1,0.005952381,0,0.14138888900000002,4.0089999999999995,99.0,131,2.7027027027027026,36
230,4662188,2,7,12,34,5316259,89,266,4.606060606000001,68,0.255639098,1,16.10083333,265.94,91.91176471,177,76.40449438202246,21
231,4657106,3,7,13,42,5168442,116,219,4.230769231,92,0.420091324,1,20.60861111,429.27099999999996,104.96739129999999,103,79.3103448275862,24
232,4650483,4,7,22,58,4712121,147,183,4.5806451610000005,119,0.650273224,1,32.30972222,540.469,107.0504202,36,80.95238095238095,28
233,4631045,4,7,10,28,3105855,86,210,4.2173913039999995,47,0.22380952399999998,1,11.76777778,158.70600000000002,83.89361702,124,54.65116279069767,39
234,4626980,2,7,21,14,4198519,106,174,4.322580645,69,0.396551724,1,16.425,293.372,101.7536232,68,65.09433962264151,37
235,4608464,6,7,22,46,5253437,84,126,4.1724137930000005,61,0.484126984,1,12.87777778,209.053,94.24590164,42,72.61904761904762,23
236,4598077,5,7,14,20,3887546,202,234,4.1830985919999994,155,0.662393162,1,45.04333333,733.9,107.52903229999998,32,76.73267326732673,47
237,4579461,7,7,1,46,5413960,72,89,4.5,62,0.696629213,1,13.525,272.922,107.32258059999998,17,86.11111111111111,10
238,4578390,3,7,9,53,3603914,49,120,4.47826087,42,0.35,1,13.45722222,211.305,108.6904762,71,85.71428571428571,7
239,4573559,1,7,13,8,5388820,71,156,4.05,46,0.294871795,1,11.8,196.252,96.76086957,85,64.7887323943662,25
240,4571584,5,7,12,7,3973870,44,125,4.5,21,0.168,1,5.062777778,118.81200000000001,124.952381,81,47.72727272727273,23
241,4553888,3,7,7,35,4844932,39,92,4.125,37,0.402173913,1,9.854444444,167.14700000000002,101.86486490000001,53,94.87179487179486,2
242,4536821,4,7,15,15,4513456,64,141,4.333333333,44,0.312056738,1,13.55166667,231.675,113.7727273,77,68.75,20
243,4531818,6,7,15,6,3784032,45,69,4.375,28,0.405797101,1,6.6444444439999995,104.35600000000001,90.64285714,24,62.22222222222222,17
244,4517800,7,7,13,30,4595693,38,239,4.055555556,30,0.12552301300000002,1,8.043888889,147.036,105.36666670000001,201,78.94736842105263,8
245,4511960,1,7,19,1,4761024,55,95,4.2380952380000005,35,0.36842105299999994,1,10.88444444,193.515,116.02857140000002,40,63.63636363636363,20
246,4486760,3,7,11,12,4718729,43,110,4.4,17,0.154545455,1,4.2525,72.423,103.11764709999999,67,39.53488372093023,26
247,4435017,1,7,19,26,4933629,64,423,4.307692308,32,0.075650118,1,7.19,140.238,101.5,359,50.0,32
248,4424145,3,7,17,12,4962783,177,358,4.23255814,83,0.231843575,1,25.05416667,450.295,115.1445783,181,46.89265536723164,94
249,4423445,4,7,21,50,5335592,72,94,4.307692308,23,0.244680851,1,4.086111111,88.89,96.34782609,22,31.944444444444443,49
250,4416220,7,7,10,34,5312074,67,119,3.0,28,0.235294118,1,5.3325,97.16799999999999,87.5,52,41.7910447761194,39
251,4364336,6,7,17,53,4736975,64,129,4.5,42,0.325581395,1,10.31138889,187.993,101.8571429,65,65.625,22
252,4360090,3,7,20,18,3821612,73,200,4.578947368,42,0.21,1,7.557777777999999,200.59900000000002,116.07142859999999,127,57.534246575342465,31
253,4357327,5,7,16,42,4697790,82,155,4.461538462,25,0.161290323,1,6.5430555560000005,143.39700000000002,121.8,73,30.48780487804878,57
254,4353988,4,7,17,38,4362961,73,167,4.0,18,0.107784431,1,0.665,47.313,77.27777778,94,24.65753424657534,55
255,4349923,3,7,17,55,5347447,74,141,4.307692308,59,0.418439716,1,13.76888889,255.593,98.57627119,67,79.72972972972973,15
256,4347031,1,7,18,59,3072521,67,380,4.125,30,0.078947368,1,3.335833333,74.942,78.76666667,313,44.776119402985074,37
257,4341426,6,7,17,29,4383993,40,98,4.214285714,27,0.275510204,1,11.39805556,220.424,157.33333330000002,58,67.5,13
258,4331916,2,7,15,22,3368680,132,189,4.045454545,85,0.44973545,1,20.04555556,333.13199999999995,91.2,57,64.39393939393939,47
259,4322991,2,7,7,32,4670561,79,131,4.096774194,55,0.41984732799999996,1,15.07972222,278.036,107.8,52,69.62025316455697,24
260,4284999,5,7,18,56,5397764,74,163,4.473684211,46,0.282208589,1,12.80638889,172.655,89.15217391,89,62.16216216216216,28
261,4259559,3,7,22,21,4157099,64,319,4.384615385,32,0.10031348,1,5.6166666670000005,119.64399999999999,113.25,255,50.0,32
262,4254553,3,7,11,2,5046882,129,299,4.444444444,99,0.331103679,1,25.93361111,466.135,106.020202,170,76.74418604651163,30
263,4195544,1,7,8,52,4387848,71,169,4.391304348,51,0.301775148,1,10.90722222,219.963,98.96078431,98,71.83098591549296,20
264,4186809,3,7,9,58,5282215,74,349,4.1,37,0.106017192,1,2.695833333,124.59100000000001,89.62162162,275,50.0,37
265,4155636,6,7,0,6,3987360,54,144,4.8,12,0.083333333,1,1.6844444440000002,45.501000000000005,113.25,90,22.22222222222222,42
266,4121365,7,7,18,7,5410729,55,133,4.181818182,18,0.135338346,1,3.2219444439999996,38.43,68.16666667,78,32.72727272727273,37
267,4028165,2,7,21,35,5313801,55,308,4.714285714,13,0.042207792,1,2.730277778,68.885,123.6923077,253,23.636363636363637,42
268,4024081,5,7,12,4,4962826,67,625,4.333333333,25,0.04,1,4.427222222,67.71300000000001,75.36,558,37.3134328358209,42
269,4016310,4,7,18,11,4600120,67,114,4.3636363639999995,23,0.201754386,1,0.47722222200000003,19.082,51.86956522,47,34.32835820895522,44
270,3983314,3,7,10,46,4005809,64,79,4.318181818,48,0.607594937,1,10.08,181.908,88.41666667,15,75.0,16
271,3978167,1,7,9,29,3518252,69,137,4.55,47,0.34306569299999995,1,11.67277778,200.864,99.9787234,68,68.11594202898551,22
272,3954133,4,7,1,16,5057417,104,148,4.380952381,54,0.364864865,1,10.98111111,269.393,152.462963,44,51.92307692307693,50
273,3943399,2,7,10,13,5187418,30,88,4.2,12,0.13636363599999998,1,4.274166667,73.503,126.58333329999999,58,40.0,18
274,3876668,5,7,15,4,4347059,102,419,4.3636363639999995,47,0.11217183800000001,1,7.6838888889999994,147.278,84.10638298,317,46.07843137254902,55
275,3850962,1,7,10,30,4447912,59,114,4.434782609,47,0.41228070200000005,1,11.53666667,230.291,107.8297872,55,79.66101694915254,12
276,3849192,2,7,18,27,4772789,32,174,4.333333333,13,0.07471264400000001,1,4.278888889,66.688,109.4615385,142,40.625,19
277,3820335,6,7,16,30,4679189,17,117,4.4,9,0.076923077,1,0.36972222200000004,23.877,77.66666667,100,52.94117647058824,8
278,3813528,1,7,18,33,3342501,56,201,4.533333333,25,0.124378109,1,6.6958333329999995,120.305,125.32,145,44.642857142857146,31
279,3762069,6,7,8,32,3047532,83,217,4.178571429,58,0.267281106,1,17.66388889,324.21299999999997,118.1724138,134,69.87951807228916,25
280,3762058,1,7,10,24,4519577,105,197,4.25,84,0.426395939,1,23.09305556,425.131,114.2857143,92,80.0,21
281,3751543,5,7,19,38,5384557,20,159,4.714285714,11,0.06918239,1,3.462222222,64.208,118.6363636,139,55.00000000000001,9
282,3733395,2,7,16,0,5128726,49,80,4.166666667,36,0.45,1,9.039444443999999,163.061,100.9444444,31,73.46938775510205,13
283,3707646,3,7,6,47,4673324,104,222,4.291666667,90,0.405405405,1,25.91916667,429.26599999999996,104.4777778,118,86.53846153846155,14
284,3695674,3,7,14,45,5283929,186,228,4.578947368,97,0.425438596,1,29.10166667,476.045,106.2061856,42,52.1505376344086,89
285,3678744,2,7,17,0,3640539,61,182,4.4375,46,0.252747253,1,15.49305556,243.541,110.78260870000001,121,75.40983606557377,15
286,3626950,4,7,10,33,5207970,104,201,4.6111111110000005,35,0.17412935300000001,1,9.415277778,174.791,108.0571429,97,33.65384615384615,69
287,3500720,3,7,12,35,4823286,59,117,3.8461538460000004,42,0.35897435899999997,1,11.96055556,202.833,106.7380952,58,71.1864406779661,17
288,3435189,4,7,21,34,5154501,60,227,4.4375,33,0.14537444900000002,1,9.191111111,195.80700000000002,129.8181818,167,55.00000000000001,27
289,3401681,4,7,21,24,3271592,39,191,4.75,13,0.068062827,1,3.409722222,59.763000000000005,105.2307692,152,33.33333333333333,26
290,3355215,3,7,13,19,3113303,37,147,4.214285714,25,0.17006802699999998,1,6.6502777779999995,148.029,123.16,110,67.56756756756756,12
291,3243390,5,7,9,38,5137831,110,336,4.315789474,38,0.113095238,1,8.759444444,140.077,88.76315789,226,34.54545454545455,72
292,3090872,3,7,13,7,3510245,117,371,4.384615385,50,0.134770889,1,13.84833333,269.915,114.66,254,42.73504273504273,67
293,3060896,2,7,8,37,5151403,96,213,3.947368421,50,0.23474178399999998,1,14.28388889,241.543,107.22,117,52.083333333333336,46
294,3023513,1,7,10,58,5219120,41,94,3.6,8,0.08510638300000001,1,2.035,38.92,107.125,53,19.51219512195122,33
295,2974966,3,7,21,13,4202837,55,318,4.571428571,16,0.050314465,1,4.271111111000001,64.296,100.4375,263,29.09090909090909,39
296,2940519,2,7,10,59,5145110,62,264,4.058823529,36,0.13636363599999998,1,5.852777777999999,140.00799999999998,95.33333333,202,58.06451612903226,26
297,2928777,1,7,8,41,3802452,72,172,4.0,41,0.238372093,1,10.01611111,211.78799999999998,113.2439024,100,56.94444444444444,31
298,2926170,4,7,9,41,4013501,51,224,3.833333333,33,0.147321429,1,11.31111111,176.49400000000003,114.48484850000001,173,64.70588235294117,18
299,2926142,1,7,16,6,5361681,73,144,4.416666667,46,0.319444444,1,11.51361111,191.33599999999998,96.82608696,71,63.013698630136986,27
300,2913912,2,7,15,12,5059347,31,159,4.285714286,15,0.09433962300000001,1,4.3975,73.51,106.93333329999999,128,48.38709677419355,16
301,5404803,6,6,12,20,5139120,78,109,4.1428571430000005,54,0.49541284399999996,1,17.98,296.959,117.0,31,69.23076923076923,24
302,5404434,3,6,18,48,4248003,22,138,4.8571428569999995,15,0.10869565199999999,1,4.057777778,71.866,106.66666670000001,116,68.18181818181817,7
303,5404280,7,6,23,17,5444250,63,168,4.24,48,0.28571428600000004,1,12.22527778,208.202,103.39583329999999,105,76.19047619047619,15
304,5404169,5,6,11,4,4280939,77,223,4.03125,61,0.273542601,1,13.14694444,231.623,91.27868852,146,79.22077922077922,16
305,5402506,5,6,10,46,4869744,88,118,4.043478261000001,46,0.38983050799999996,1,25.8825,229.13400000000001,108.6304348,30,52.27272727272727,42
306,5402488,7,6,20,0,5091471,73,150,3.894736842,50,0.333333333,1,14.73583333,219.18400000000003,101.54,77,68.4931506849315,23
307,5402167,5,6,16,56,3362857,60,147,4.434782609,46,0.31292517,1,13.14333333,217.041,106.06521740000001,87,76.66666666666667,14
308,5397362,3,6,18,27,5222148,45,140,4.5,26,0.185714286,1,7.931944444,137.032,113.92307690000001,95,57.77777777777777,19
309,5397309,1,6,19,42,4928157,42,57,4.5625,32,0.561403509,1,7.03,125.44,91.5,15,76.19047619047619,10
310,5397186,3,6,20,41,5414984,78,182,4.454545455,57,0.313186813,1,13.00083333,234.083,96.78947368,104,73.07692307692307,21
311,5395899,5,6,12,4,4589146,55,91,4.1111111110000005,20,0.21978022,1,2.5375,49.961999999999996,76.75,36,36.36363636363637,35
312,5395257,2,6,19,45,5199388,57,102,4.4375,36,0.352941176,1,8.187777778,147.829,92.38888889,45,63.1578947368421,21
313,5395190,5,6,9,14,5199302,71,164,4.125,47,0.286585366,1,15.43027778,285.496,127.02127659999998,93,66.19718309859155,24
314,5395014,4,6,19,50,5421641,46,117,4.2,31,0.264957265,1,0.45777777799999997,87.77,80.74193548,71,67.3913043478261,15
315,5394986,4,6,9,25,3250007,40,51,4.266666667,31,0.607843137,1,11.27694444,154.19,109.32258059999998,11,77.5,9
316,5394838,1,6,19,12,4361031,51,271,4.666666667,5,0.018450185,1,0.038888888999999996,5.632000000000001,57.2,220,9.803921568627452,46
317,5390040,2,6,9,14,4500565,79,145,4.2352941180000006,37,0.25517241399999996,1,11.25694444,176.328,105.5135135,66,46.835443037974684,42
318,5389673,4,6,17,19,5024854,29,81,3.333333333,20,0.24691358,1,4.495555556,74.949,87.05,52,68.96551724137932,9
319,5389309,2,6,23,16,4889332,54,67,4.666666667,42,0.626865672,1,11.75416667,182.81,102.547619,13,77.77777777777779,12
320,5387862,5,6,11,12,5118384,44,131,3.8181818180000002,23,0.17557251899999998,1,5.489166667,77.07300000000001,82.21739129999999,87,52.27272727272727,21
321,5381935,5,6,10,44,5276769,82,193,3.35,51,0.264248705,1,13.05833333,222.734,100.33333329999999,111,62.19512195121951,31
322,5381254,3,6,20,7,4870676,35,78,4.352941176,31,0.39743589700000004,1,7.0625,126.67200000000001,96.32258065,43,88.57142857142857,4
323,5381113,2,6,21,43,5191665,67,114,4.333333333,55,0.48245614,1,15.72194444,298.233,118.2,47,82.08955223880598,12
324,5374849,1,6,19,59,4762817,32,73,4.769230769,24,0.328767123,1,6.109166667,116.023,104.45833329999999,41,75.0,8
325,5374736,2,6,12,8,4508338,47,64,4.692307692,38,0.59375,1,9.497777778,168.49099999999999,99.13157895,17,80.85106382978722,9
326,5374734,3,6,19,16,4985643,94,130,4.066666667,74,0.569230769,1,15.11944444,297.76599999999996,93.94594595,36,78.72340425531915,20
327,5374557,3,6,18,49,3065412,49,121,3.842105263,32,0.26446281,1,9.433888889,147.083,104.8125,72,65.3061224489796,17
328,5374170,3,6,11,53,4205970,62,129,4.1875,40,0.31007751899999997,1,14.48,186.679,105.225,67,64.51612903225806,22
329,5374141,6,6,12,37,5366085,93,191,4.414634146,83,0.434554974,1,26.63333333,380.522,102.746988,98,89.24731182795699,10
330,5373325,3,6,15,43,4768493,72,212,4.571428571,21,0.099056604,1,7.891111111,118.905,118.9047619,140,29.166666666666668,51
331,5372865,5,6,16,18,4709402,62,382,3.8,38,0.09947644,1,8.424166667,127.29899999999999,85.23684211,320,61.29032258064516,24
332,5369081,7,6,17,29,5046882,63,216,4.2,48,0.222222222,1,14.66555556,250.48,114.39583329999999,153,76.19047619047619,15
333,5368679,1,6,12,56,4665347,52,59,4.1363636360000005,37,0.627118644,1,8.838333333,152.137,95.45945946,7,71.15384615384616,15
334,5367397,2,6,20,2,5305743,70,201,4.461538462,51,0.253731343,1,11.835,257.971,113.39215690000002,131,72.85714285714285,19
335,5366616,7,6,10,45,5195938,70,217,4.3928571430000005,53,0.244239631,1,14.38666667,256.79,104.0943396,147,75.71428571428571,17
336,5366434,3,6,14,13,5248801,53,72,4.454545455,43,0.5972222220000001,1,12.05222222,206.78799999999998,106.3255814,19,81.13207547169812,10
337,5361534,2,6,14,36,3038898,39,108,4.5,28,0.25925925899999996,1,10.06472222,166.19099999999997,125.0,69,71.7948717948718,11
338,5361523,1,6,18,0,5312703,66,116,4.545454545,42,0.362068966,1,11.69361111,201.17700000000002,105.5238095,50,63.63636363636363,24
339,5361443,4,6,20,17,3778832,25,71,4.1,20,0.281690141,1,4.178611111,65.249,83.5,46,80.0,5
340,5360574,1,6,18,12,5092901,18,39,4.555555556,13,0.333333333,1,4.373888889,59.82,101.38461540000002,21,72.22222222222221,5
341,5359947,4,6,21,27,5304065,60,115,4.1578947369999995,48,0.41739130399999996,1,13.23805556,261.339,119.29166670000001,55,80.0,12
342,5357726,3,6,18,34,3746290,66,214,4.115384615,48,0.224299065,1,16.10277778,236.768,106.97916670000001,148,72.72727272727273,18
343,5356164,5,6,14,24,3588141,23,71,4.0,16,0.22535211300000002,1,4.188888888999999,83.484,110.1875,48,69.56521739130434,7
344,5355529,2,6,19,49,5125000,28,59,4.714285714,26,0.44067796600000003,1,7.498611111000001,155.951,125.8076923,31,92.85714285714286,2
345,5355121,1,6,10,10,5327409,41,81,4.4,29,0.358024691,1,7.341388889,122.471,95.82758621,40,70.73170731707317,12
346,5354632,1,6,10,41,4611362,85,150,4.153846154,69,0.46,1,23.58222222,351.526,111.9710145,65,81.17647058823529,16
347,5354617,4,6,19,35,4978234,70,90,4.523809524,51,0.566666667,1,13.22777778,221.21400000000003,102.2156863,20,72.85714285714285,19
348,5354559,2,6,17,3,4904379,28,71,4.375,23,0.32394366199999997,1,6.374166667000001,84.465,88.0,43,82.14285714285714,5
349,5354553,3,6,19,20,4112443,70,116,4.5,54,0.465517241,1,15.22888889,257.207,103.7777778,46,77.14285714285715,16
350,5354133,2,6,9,32,5395583,53,127,4.1428571430000005,31,0.244094488,1,11.64361111,158.491,114.09677420000001,74,58.490566037735846,22
351,5352796,4,6,23,5,4500546,35,53,4.333333333,26,0.490566038,1,6.7986111110000005,117.023,106.88461540000002,18,74.28571428571429,9
352,5348572,2,6,12,39,4830048,42,155,4.875,12,0.077419355,1,2.8444444439999996,51.19,99.66666667,113,28.57142857142857,30
353,5348233,3,6,11,47,3627432,90,163,3.7037037039999996,61,0.374233129,1,18.48111111,330.077,114.2786885,73,67.77777777777779,29
354,5348158,7,6,12,22,4942138,46,137,4.666666667,43,0.313868613,1,10.93138889,184.39,97.48837209,91,93.47826086956522,3
355,5347884,5,6,17,39,5405309,53,93,4.708333333,42,0.45161290299999995,1,8.792222222000001,159.535,89.47619048,40,79.24528301886792,11
356,5347595,4,6,12,3,4021165,47,102,4.166666667,26,0.254901961,1,4.910277778,103.78399999999999,92.69230769,55,55.319148936170215,21
357,5347073,7,6,12,56,5304139,31,162,4.272727273,21,0.12962963,1,5.076666667,104.845,109.7142857,131,67.74193548387096,10
358,5338203,3,6,18,20,3090939,31,84,4.714285714,23,0.27380952399999997,1,7.5875,119.147,110.52173909999998,53,74.19354838709677,8
359,5334092,3,6,6,26,4547437,43,91,4.3636363639999995,24,0.263736264,1,4.771944444,95.838,94.625,48,55.81395348837209,19
360,5333945,4,6,18,27,3916697,51,250,4.125,33,0.132,1,9.405555556,156.615,103.42424240000001,199,64.70588235294117,18
361,5333002,3,6,10,1,3854726,89,276,4.0,30,0.10869565199999999,1,5.209444444,111.315,90.5,187,33.70786516853933,59
362,5332597,3,6,18,1,4531509,78,170,4.3888888889999995,38,0.22352941199999998,1,13.42527778,215.166,116.0,92,48.717948717948715,40
363,5332163,1,6,16,9,3631853,58,272,3.6363636360000005,25,0.091911765,1,1.6019444440000001,48.376999999999995,66.32,214,43.103448275862064,33
364,5332149,5,6,11,23,5389694,69,119,4.590909091,53,0.445378151,1,15.6175,261.311,106.3396226,50,76.81159420289855,16
365,5332096,2,6,23,53,5400546,63,104,4.066666667,30,0.288461538,1,2.0775,73.266,77.26666667,41,47.61904761904761,33
366,5331077,3,6,12,41,5068005,47,114,4.5,42,0.36842105299999994,1,12.29194444,223.982,115.16666670000001,67,89.36170212765957,5
367,5330863,3,6,16,16,4917063,35,109,4.833333333,20,0.183486239,1,5.385277778,91.67,101.65,74,57.14285714285714,15
368,5327808,2,6,11,53,4267763,76,241,4.565217391,51,0.211618257,1,15.06722222,266.62,112.05882350000002,165,67.10526315789474,25
369,5327161,7,6,19,5,5368768,34,74,4.714285714,19,0.256756757,1,8.870277778,71.23899999999999,88.78947368,40,55.88235294117647,15
370,5325100,7,6,11,25,4647749,62,123,4.263157895,32,0.26016260199999997,1,6.944444444,150.252,103.40625,61,51.61290322580645,30
371,5324633,2,6,19,26,4694728,74,138,4.52,52,0.37681159399999997,1,9.753611111,197.795,90.19230769,64,70.27027027027027,22
372,5324300,1,6,20,2,5083886,46,123,4.5,8,0.06504065,1,2.2175,39.666,103.875,77,17.391304347826086,38
373,5323904,1,6,19,19,3261404,70,128,4.310344828,59,0.4609375,1,15.48333333,252.537,94.89830508,58,84.28571428571429,11
374,5319635,3,6,6,9,4430621,64,228,4.421052632,44,0.19298245600000002,1,11.45416667,189.243,97.43181818,164,68.75,20
375,5319424,7,6,14,25,5400843,29,86,4.444444444,20,0.23255814,1,5.279166667,128.362,131.45,57,68.96551724137932,9
376,5319005,3,6,22,8,4043504,103,250,4.108108108,64,0.256,1,15.98861111,281.86,99.4375,147,62.13592233009708,39
377,5318396,5,6,12,11,5420587,16,55,3.75,12,0.218181818,1,3.976388889,72.388,123.58333329999999,39,75.0,4
378,5317096,7,6,8,36,4726608,73,109,3.866666667,48,0.440366972,1,11.81805556,205.47099999999998,99.625,36,65.75342465753424,25
379,5313093,2,6,21,20,4538293,46,57,4.2380952380000005,39,0.684210526,1,10.72416667,211.19,117.20512820000002,11,84.78260869565217,7
380,5310359,7,6,12,36,4092079,47,64,4.3571428569999995,37,0.578125,1,9.615277778,175.437,103.1081081,17,78.72340425531915,10
381,5303987,6,6,18,15,4659896,29,116,4.75,18,0.155172414,1,3.630555556,64.186,86.66666667,87,62.06896551724138,11
382,5302790,3,6,12,47,5373797,95,267,4.555555556,56,0.20973782800000002,1,15.60916667,243.00900000000001,100.5178571,172,58.94736842105262,39
383,5298095,2,6,5,19,5061247,53,129,4.473684211,32,0.24806201600000002,1,7.158611111,155.263,105.65625,76,60.37735849056604,21
384,5297733,6,6,9,17,5309905,67,133,4.515151515,57,0.428571429,1,13.27194444,234.55599999999998,96.9122807,66,85.07462686567165,10
385,5297495,3,6,14,11,4882481,55,102,4.3636363639999995,46,0.450980392,1,14.20361111,209.101,101.3043478,47,83.63636363636363,9
386,5296471,6,6,14,26,4921305,46,102,4.444444444,30,0.294117647,1,7.3475,122.086,97.33333333,56,65.21739130434783,16
387,5294803,3,6,10,25,5387489,174,216,3.867647059,123,0.5694444439999999,1,27.385,538.317,98.64227642,42,70.6896551724138,51
388,5293143,4,6,20,31,3594243,53,152,4.5,35,0.230263158,1,7.468888889,162.664,103.1428571,99,66.0377358490566,18
389,5289574,5,6,10,29,5312044,25,181,4.5,16,0.08839779,1,5.864722222,95.039,121.125,156,64.0,9
390,5289482,7,6,22,22,4899778,16,27,4.6,12,0.444444444,1,2.231111111,36.268,91.08333333,11,75.0,4
391,5286978,2,6,18,16,5112927,77,167,4.24137931,49,0.293413174,1,12.87611111,219.253,100.9183673,90,63.63636363636363,28
392,5286388,7,6,18,49,4614229,109,279,4.0,69,0.247311828,1,19.18916667,290.785,96.56521739,170,63.30275229357798,40
393,5280558,2,6,9,59,3562391,74,118,4.1875,58,0.491525424,1,14.06833333,247.56799999999998,99.36206897,44,78.37837837837837,16
394,5275594,3,6,10,2,4887516,121,221,4.473684211,74,0.334841629,1,20.395,346.72900000000004,103.1621622,100,61.15702479338842,47
395,5272555,2,6,8,33,3711945,29,75,3.9,21,0.28,1,1.888611111,42.861000000000004,68.71428571,46,72.41379310344827,8
396,5271768,1,6,13,55,3464778,76,138,4.694444444,65,0.471014493,1,15.60416667,260.27299999999997,92.35384615,62,85.52631578947368,11
397,5270894,3,6,11,3,4342493,61,146,4.75,20,0.136986301,1,3.2619444439999996,91.934,103.6,85,32.78688524590164,41
398,5270397,7,6,17,9,3897749,85,284,4.208333333,44,0.15492957699999998,1,11.97416667,207.375,101.3636364,199,51.76470588235295,41
399,5264739,3,6,8,6,3936735,51,133,4.0,27,0.203007519,1,4.505555556,97.56299999999999,91.85185185,82,52.94117647058824,24
400,5264526,2,6,21,47,4714537,56,225,4.375,41,0.182222222,1,11.29527778,194.035,106.5609756,169,73.21428571428571,15
401,5264040,2,6,11,30,5277079,47,304,4.5,23,0.075657895,1,6.6725,113.927,110.8695652,257,48.93617021276596,24
402,5264033,5,6,15,39,4657735,67,93,3.8965517239999996,58,0.623655914,1,14.67194444,251.981,98.72413793,26,86.56716417910447,9
403,5262415,3,6,5,26,3847162,89,125,4.24137931,57,0.456,1,20.26972222,356.375,127.2280702,36,64.04494382022472,32
404,5261768,1,6,19,24,3923349,85,108,4.484848485,67,0.62037037,1,21.45444444,376.469,117.58208959999999,23,78.82352941176471,18
405,5257861,3,6,18,31,5397498,36,51,4.166666667,29,0.568627451,1,7.085833332999999,111.523,92.13793103,15,80.55555555555556,7
406,5257432,4,6,10,36,4591600,58,176,4.0,22,0.125,1,6.312777777999999,106.39399999999999,106.54545449999999,118,37.93103448275862,36
407,5256384,4,6,15,14,5250346,62,231,4.038461538,51,0.22077922100000003,1,15.55527778,215.672,96.47058824,169,82.25806451612904,11
408,5256215,7,6,9,37,5437125,19,88,4.1111111110000005,14,0.159090909,1,4.419166667,86.50200000000001,123.57142859999999,69,73.68421052631578,5
409,5255562,3,6,9,57,5300810,53,65,4.571428571,40,0.615384615,1,14.94361111,248.762,126.175,12,75.47169811320755,13
410,5255426,3,6,17,8,3842762,40,112,4.545454545,17,0.15178571400000002,1,4.276388889,70.222,95.47058824,72,42.5,23
411,5255389,2,6,19,15,3027866,44,120,4.25,37,0.308333333,1,8.861388889,189.429,117.7027027,76,84.0909090909091,7
412,5255328,1,6,10,3,5360900,50,153,3.947368421,43,0.281045752,1,6.7641666670000005,135.455,79.23255814,103,86.0,7
413,5254477,5,6,14,48,4162343,59,162,4.6315789469999995,42,0.25925925899999996,1,11.79611111,214.75,110.8571429,103,71.1864406779661,17
414,5252919,7,6,8,13,4214117,20,58,4.222222222,18,0.310344828,1,5.75,107.948,121.83333329999999,38,90.0,2
415,5252585,2,6,19,1,4367270,46,185,4.0,38,0.205405405,1,7.476666667000001,139.241,90.42105263,139,82.6086956521739,8
416,5252376,2,6,13,30,3825914,54,62,4.185185185,47,0.7580645159999999,1,16.51638889,287.197,124.1489362,8,87.03703703703704,7
417,5250178,3,6,22,30,4937991,48,100,4.352941176,37,0.37,1,12.26083333,225.907,130.1621622,52,77.08333333333334,11
418,5249560,7,6,17,27,5283554,66,259,4.117647058999999,43,0.166023166,1,12.99777778,207.195,105.8837209,193,65.15151515151516,23
419,5249464,1,6,8,3,5249963,75,189,4.3571428569999995,48,0.253968254,1,10.92305556,156.90200000000002,86.10416667,114,64.0,27
420,5248886,4,6,8,42,4287683,100,105,4.489795918,87,0.828571429,1,24.095,420.431,103.33333329999999,5,87.0,13
421,5248041,4,6,7,21,4983462,52,111,3.842105263,37,0.333333333,1,11.06416667,191.085,108.7027027,59,71.15384615384616,15
422,5245536,2,6,12,19,3945761,80,158,4.058823529,32,0.202531646,1,6.9058333329999995,141.931,100.78125,78,40.0,48
423,5245211,2,6,9,3,3047251,94,182,4.485714286,60,0.32967033,1,15.65888889,273.62,100.75,88,63.829787234042556,34
424,5239592,5,6,6,59,4443156,86,99,4.119047619,76,0.767676768,1,17.79527778,311.499,95.02631579,13,88.37209302325581,10
425,5231905,4,6,17,27,3837470,105,171,4.186046512,85,0.497076023,1,22.78138889,439.77099999999996,119.18823529999999,66,80.95238095238095,20
426,5228266,4,6,16,35,4910767,103,197,4.4,36,0.18274111699999998,1,0.040833333,54.143,62.91666667,94,34.95145631067961,67
427,5226786,1,6,10,41,3984569,53,91,4.3571428569999995,27,0.296703297,1,4.429722222,96.178,88.59259259,38,50.943396226415096,26
428,5226534,4,6,9,32,5125925,96,203,4.0,16,0.078817734,1,1.276944444,36.498000000000005,74.5,107,16.666666666666664,80
429,5226360,3,6,8,21,3985447,114,174,4.333333333,87,0.5,1,24.0425,417.209,105.0114943,60,76.31578947368422,27
430,5219893,2,6,18,29,5180445,16,30,5.0,10,0.333333333,1,4.448333333,82.01700000000001,153.0,14,62.5,6
431,5219142,3,6,12,54,4751968,60,132,4.05,47,0.356060606,1,30.75916667,264.01,118.42553190000001,72,78.33333333333333,13
432,5216259,7,6,9,45,4905796,25,87,4.714285714,12,0.137931034,1,2.634444444,51.797,100.0,62,48.0,13
433,5211972,2,6,14,55,4887604,25,74,4.5,21,0.283783784,1,6.034444444,104.81200000000001,108.9047619,49,84.0,4
434,5211305,1,6,17,33,3042525,63,200,4.0,10,0.05,1,2.290555556,45.162,103.5,137,15.873015873015872,53
435,5210850,7,6,10,50,4037601,24,41,4.545454545,14,0.341463415,1,2.749444444,54.248000000000005,89.28571429,17,58.333333333333336,10
436,5210534,1,6,21,14,5223194,25,36,3.7,21,0.583333333,1,4.9566666669999995,93.23700000000001,102.61904759999999,11,84.0,4
437,5206289,4,6,18,42,4058013,74,119,4.5,56,0.470588235,1,14.66222222,216.91400000000002,89.71428571,45,75.67567567567568,18
438,5205496,2,6,13,44,4574866,41,118,4.347826087,33,0.279661017,1,11.54833333,178.34599999999998,112.969697,77,80.48780487804879,8
439,5205270,2,6,5,33,4006485,19,58,5.0,12,0.20689655199999998,1,3.938611111,60.81100000000001,108.83333329999999,39,63.1578947368421,7
440,5204436,1,6,15,7,4422397,35,64,4.666666667,28,0.4375,1,8.618055556,152.116,111.8928571,29,80.0,7
441,5204340,1,6,9,19,4865957,81,154,4.225806452,61,0.396103896,1,15.79972222,255.65,94.72131148,73,75.30864197530865,20
442,5203691,3,6,19,0,5405353,33,62,4.666666667,11,0.177419355,1,2.536388889,36.312,83.27272727,29,33.33333333333333,22
443,5203567,1,6,5,36,4963881,56,81,4.3636363639999995,45,0.5555555560000001,1,9.869722222,205.393,104.5555556,25,80.35714285714286,11
444,5202646,4,6,16,42,5420193,87,108,4.307692308,66,0.611111111,1,20.37055556,319.172,104.71212120000001,21,75.86206896551724,21
445,5198297,7,6,21,8,5082792,121,315,4.348837209,84,0.26666666699999997,1,27.5075,445.801,114.3452381,194,69.42148760330579,37
446,5189448,2,6,8,22,4034551,115,314,4.324324324,68,0.21656051,1,21.17833333,348.309,112.44117649999998,199,59.130434782608695,47
447,5188420,5,6,9,21,4499833,25,34,4.75,20,0.588235294,1,4.784444444,94.40299999999999,102.05,9,80.0,5
448,5178953,2,6,7,21,4903371,37,156,4.533333333,25,0.16025641,1,10.05888889,178.226,141.16,119,67.56756756756756,12
449,5174834,3,6,19,24,4522848,16,34,4.0,5,0.147058824,1,1.748611111,27.34,112.8,18,31.25,11
450,5170169,3,6,17,26,5283732,85,200,4.416666667,51,0.255,1,15.74388889,273.38599999999997,113.31372549999999,115,60.0,34
451,5169474,6,6,12,13,4444541,71,138,4.379310345,54,0.39130434799999997,1,21.52166667,298.559,117.55555559999999,67,76.05633802816901,17
452,5169313,5,6,17,27,5020394,30,55,4.285714286,19,0.345454545,1,5.0033333330000005,85.35600000000001,99.21052632,25,63.33333333333333,11
453,5169181,3,6,17,4,4411652,52,167,4.625,41,0.245508982,1,8.818611111000001,169.15200000000002,98.70731707,115,78.84615384615384,11
454,5168824,5,6,17,57,4157686,52,98,4.6111111110000005,30,0.30612244899999996,1,7.210833332999999,114.01100000000001,94.2,46,57.692307692307686,22
455,5166041,1,6,20,33,4579905,42,112,3.8,30,0.267857143,1,9.37,135.194,101.7666667,70,71.42857142857143,12
456,5165804,7,6,19,43,3831610,31,68,4.454545455,20,0.294117647,1,5.339444444,117.59,120.75,37,64.51612903225806,11
457,5165788,4,6,17,49,5406035,63,143,4.2380952380000005,46,0.321678322,1,16.44833333,245.53900000000002,110.17391299999998,80,73.01587301587301,17
458,5165101,6,6,11,24,5325454,75,85,4.6071428569999995,61,0.717647059,1,16.81277778,293.518,105.36065570000001,10,81.33333333333333,14
459,5165081,5,6,18,16,4233317,18,52,4.285714286,13,0.25,1,2.805277778,58.018,98.38461538,34,72.22222222222221,5
460,5165078,1,6,20,25,3608464,60,87,4.391304348,49,0.563218391,1,13.86194444,243.37900000000002,106.18367350000001,27,81.66666666666667,11
461,5164551,2,6,9,8,4715283,56,81,4.5,35,0.432098765,1,10.39888889,177.095,107.08571429999999,25,62.5,21
462,5164176,4,6,18,29,4615814,19,62,3.833333333,12,0.193548387,1,3.1938888889999997,70.44800000000001,123.16666670000001,43,63.1578947368421,7
463,5160519,3,6,10,40,3988017,96,127,4.12195122,72,0.566929134,1,18.47333333,307.253,97.16666667,31,75.0,24
464,5159535,3,6,8,20,4527203,42,95,4.266666667,30,0.31578947399999996,1,10.17111111,173.62900000000002,118.9,53,71.42857142857143,12
465,5159079,5,6,15,23,4183761,38,70,3.857142857,28,0.4,1,10.91277778,97.53399999999999,87.53571429,32,73.68421052631578,10
466,5154441,2,6,20,28,4568353,37,141,4.3636363639999995,32,0.226950355,1,8.116944444,172.64,119.40625,104,86.48648648648648,5
467,5141790,3,6,13,12,3494352,117,188,4.657142857,73,0.38829787200000004,1,14.62944444,291.437,92.69863014,71,62.39316239316239,44
468,5139894,1,6,16,29,4856698,69,174,4.333333333,49,0.281609195,1,15.13027778,268.983,117.18367350000001,105,71.01449275362319,20
469,5139500,4,6,17,34,3228526,49,107,4.05,33,0.308411215,1,7.413055556000001,131.721,92.60606061,58,67.3469387755102,16
470,5138131,5,6,8,42,5409206,9,54,4.666666667,8,0.148148148,1,3.9044444439999997,64.857,159.25,45,88.88888888888889,1
471,5137945,7,6,19,27,5146637,57,138,4.263157895,42,0.304347826,1,15.20222222,253.412,122.8809524,81,73.68421052631578,15
472,5137931,7,6,10,30,4910490,25,513,4.666666667,11,0.021442495,1,2.6825,47.46,97.54545455,488,44.0,14
473,5137417,1,6,13,33,5319805,102,154,4.578947368,81,0.525974026,1,20.43388889,377.93699999999995,104.7530864,52,79.41176470588235,21
474,5130068,7,6,19,5,4792240,44,175,3.571428571,28,0.16,1,7.652777778,130.313,105.0357143,131,63.63636363636363,16
475,5126940,3,6,6,5,4726371,44,104,4.2,35,0.33653846200000004,1,8.453888889,139.09799999999998,93.08571429,60,79.54545454545455,9
476,5122730,6,6,15,43,4195569,15,256,4.5,6,0.0234375,1,1.548611111,28.37,105.16666670000001,241,40.0,9
477,5122002,7,6,16,11,3646317,37,136,4.307692308,31,0.22794117600000002,1,8.584444443999999,131.375,95.35483871,99,83.78378378378379,6
478,5121110,3,6,8,39,4782806,68,233,4.344827586,49,0.21030042899999998,1,16.43777778,314.619,129.4693878,165,72.05882352941177,19
479,5115955,2,6,21,33,3569000,48,83,4.181818182,35,0.42168674700000003,1,8.739444444,165.03900000000002,104.9428571,35,72.91666666666666,13
480,5110612,2,6,20,13,4211341,49,147,4.375,27,0.18367346899999998,1,5.914444444,124.574,101.0,98,55.10204081632652,22
481,5107614,7,6,12,43,5131011,63,170,4.1428571430000005,30,0.176470588,1,10.14861111,160.668,113.13333329999999,107,47.61904761904761,33
482,5107074,2,6,15,1,4723508,56,179,4.818181818,26,0.145251397,1,10.25277778,144.553,117.2307692,123,46.42857142857143,30
483,5106434,2,6,13,58,3493164,69,84,4.333333333,54,0.642857143,1,17.22111111,205.44799999999998,90.75925926,15,78.26086956521739,15
484,5106316,3,6,9,26,4867548,34,63,3.916666667,19,0.301587302,1,4.9325,64.206,83.10526316,29,55.88235294117647,15
485,5105178,1,6,8,26,5394103,53,277,4.733333333,44,0.158844765,1,10.71555556,187.433,95.45454545,224,83.01886792452831,9
486,5096387,2,6,16,32,4605130,56,85,4.5,41,0.48235294100000004,1,10.14055556,190.86900000000003,116.95121950000001,29,73.21428571428571,15
487,5084423,4,6,12,16,3979845,62,146,4.833333333,14,0.095890411,1,4.930555556,77.405,115.5,84,22.58064516129032,48
488,5080337,1,6,8,34,4977102,37,71,4.333333333,22,0.309859155,1,3.972222222,81.70100000000001,90.45454545,34,59.45945945945946,15
489,5073160,4,6,9,18,4422923,8,87,4.333333333,6,0.068965517,1,1.9344444440000002,29.74,109.5,79,75.0,2
490,5073148,2,6,16,3,4870037,32,93,4.833333333,16,0.17204301100000002,1,3.501388889,62.102,88.25,61,50.0,16
491,5071047,1,6,16,49,3785713,28,86,4.833333333,17,0.197674419,1,4.823611111,70.95,98.76470588,58,60.71428571428571,11
492,5070523,1,6,10,26,4988745,48,109,4.214285714,29,0.266055046,1,9.202222222,175.63,121.48275859999998,61,60.416666666666664,19
493,5069685,2,6,11,8,4950226,68,113,3.916666667,51,0.45132743399999997,1,13.44194444,209.032,93.03921569,45,75.0,17
494,5067678,4,6,16,12,4110399,34,153,4.5,28,0.18300653600000003,1,7.976111111,135.819,105.4642857,119,82.35294117647058,6
495,5066782,4,6,16,9,5362456,106,361,4.260869565,55,0.152354571,1,15.6275,253.354,101.3454545,255,51.886792452830186,51
496,5060587,3,6,10,32,3923438,81,219,3.928571429,42,0.191780822,1,11.97416667,172.97,95.45238095,138,51.85185185185185,39
497,5058736,4,6,8,53,4631748,116,293,4.1111111110000005,46,0.156996587,1,13.02277778,210.65900000000002,99.67391304,177,39.6551724137931,70
498,5058727,2,6,12,28,3701140,92,168,4.2,59,0.35119047600000003,1,11.17805556,216.095,86.47457627,76,64.13043478260869,33
499,5051368,7,6,13,18,4912382,44,101,3.933333333,33,0.32673267300000003,1,9.227777778,134.565,92.27272727,57,75.0,11
500,5050680,5,6,18,18,4735562,47,76,4.307692308,27,0.35526315799999997,1,4.446944444,93.34899999999999,87.40740741,29,57.446808510638306,20
501,5039886,4,6,20,17,4033621,43,132,4.736842105,36,0.272727273,1,10.52611111,191.076,115.5,89,83.72093023255815,7
502,5034262,7,6,22,14,5054770,38,59,3.833333333,29,0.491525424,1,7.734444444,153.257,111.8965517,21,76.31578947368422,9
503,5029226,4,6,10,26,3675480,44,151,4.666666667,36,0.238410596,1,10.65583333,167.175,101.4444444,107,81.81818181818183,8
504,5026569,1,6,10,23,5107870,147,194,4.5138888889999995,116,0.597938144,1,33.89972222,563.687,106.2758621,47,78.91156462585033,31
505,5026118,1,6,10,19,4529587,42,272,4.307692308,29,0.106617647,1,8.040555556000001,149.384,111.96551720000001,230,69.04761904761905,13
506,5026015,7,6,19,56,4319676,43,287,4.666666667,27,0.094076655,1,10.74555556,204.148,146.8148148,244,62.7906976744186,16
507,5018387,2,6,8,6,4202189,24,95,4.0,18,0.18947368399999998,1,4.790277778,89.021,105.1111111,71,75.0,6
508,5008665,2,6,17,7,5030834,60,81,4.461538462,45,0.5555555560000001,1,13.18722222,211.483,102.8,21,75.0,15
509,5005974,1,6,19,34,4358566,24,66,4.272727273,18,0.272727273,1,4.100277778,89.97200000000001,109.16666670000001,42,75.0,6
510,5005212,4,6,9,46,4892799,35,111,4.272727273,23,0.207207207,1,6.342777777999999,108.338,107.7391304,76,65.71428571428571,12
511,5003092,4,6,19,6,4168039,68,126,4.315789474,39,0.30952381,1,11.68583333,170.894,100.7692308,58,57.35294117647059,29
512,4995469,5,6,9,13,4043522,24,51,3.5555555560000003,20,0.39215686299999997,1,3.513888889,72.78,90.15,27,83.33333333333334,4
513,4986145,7,6,13,42,4589681,24,44,4.3,22,0.5,1,5.3488888889999995,99.75200000000001,101.59090909999999,20,91.66666666666666,2
514,4985523,4,6,23,3,4328902,69,114,4.2,55,0.48245614,1,17.26388889,302.895,117.5818182,45,79.71014492753623,14
515,4984851,1,6,20,24,3228006,45,69,3.75,35,0.5072463770000001,1,7.121111111,146.993,98.0,24,77.77777777777779,10
516,4984387,3,6,14,12,4332191,76,171,4.365853659,65,0.380116959,1,19.75611111,356.142,113.0461538,95,85.52631578947368,11
517,4983472,5,6,21,16,4884681,19,81,4.0,6,0.074074074,1,1.310277778,26.631999999999998,102.33333329999999,62,31.57894736842105,13
518,4970658,2,6,11,17,4181603,23,62,3.0,4,0.064516129,1,0.999166667,15.753,89.0,39,17.391304347826086,19
519,4968175,7,6,15,15,3214975,46,75,4.533333333,36,0.48,1,9.919166667,168.533,104.66666670000001,29,78.26086956521739,10
520,4967571,2,6,22,56,4441966,51,122,4.380952381,37,0.303278689,1,9.183333333,168.648,103.5675676,71,72.54901960784314,14
521,4965389,2,6,16,20,5222620,81,155,4.583333333,52,0.335483871,1,13.04777778,264.70799999999997,110.17307690000001,74,64.19753086419753,29
522,4965137,4,6,14,21,4366656,43,59,4.25,36,0.610169492,1,8.264444444,177.234,107.69444440000001,16,83.72093023255815,7
523,4960908,5,6,17,47,4969178,69,135,4.16,53,0.392592593,1,9.383055556,165.865,84.66037736,66,76.81159420289855,16
524,4958782,2,6,6,43,3078160,53,221,4.55,36,0.162895928,1,10.70861111,190.18900000000002,112.41666670000001,168,67.9245283018868,17
525,4958474,4,6,9,7,4555681,37,71,4.125,33,0.46478873200000004,1,9.085833333,159.74,106.1515152,34,89.1891891891892,4
526,4958350,1,6,19,49,3990665,102,332,4.625,45,0.135542169,1,11.45138889,225.43900000000002,110.33333329999999,230,44.11764705882353,57
527,4958007,5,6,14,53,4432920,51,132,3.666666667,25,0.18939393899999998,1,7.874722222000001,126.414,110.2,81,49.01960784313725,26
528,4946836,1,6,9,57,3993237,75,127,4.454545455,41,0.322834646,1,7.884722222000001,169.743,95.70731707,52,54.666666666666664,34
529,4942239,6,6,18,27,4409547,40,275,4.666666667,4,0.014545455,1,0.0011111110000000001,18.660999999999998,115.5,235,10.0,36
530,4940284,1,6,14,27,4949789,120,197,4.575,76,0.38578680200000004,1,22.75055556,369.914,105.82894740000002,77,63.33333333333333,44
531,4939232,6,6,8,51,3878369,30,195,4.5,22,0.11282051300000001,1,4.694722222,99.31700000000001,103.59090909999999,165,73.33333333333333,8
532,4936533,3,6,17,25,5174906,46,150,4.714285714,34,0.226666667,1,10.24361111,155.385,103.8529412,104,73.91304347826086,12
533,4935252,7,6,10,44,5152140,42,114,4.529411765,33,0.289473684,1,8.633611111,154.066,103.5454545,72,78.57142857142857,9
534,4933315,7,6,17,5,4519266,50,93,4.0,35,0.376344086,1,10.36666667,191.747,114.62857140000001,43,70.0,15
535,4933002,5,6,12,19,4825475,97,114,4.4,76,0.666666667,1,20.53388889,348.06300000000005,99.85526316,17,78.35051546391753,21
536,4920430,4,6,11,4,5118384,62,124,4.5,38,0.306451613,1,11.98916667,191.455,108.73684209999999,62,61.29032258064516,24
537,4915041,5,6,16,28,5017780,50,289,4.444444444,35,0.12110726599999999,1,7.468888889,144.906,95.74285714,239,70.0,15
538,4912412,3,6,16,21,5265182,39,113,4.538461538,34,0.30088495600000004,1,11.46527778,184.40599999999998,113.9705882,74,87.17948717948718,5
539,4907992,1,6,13,27,4831671,79,144,4.1428571430000005,21,0.145833333,1,5.306666667,71.72,85.23809524,65,26.582278481012654,58
540,4889482,7,6,7,44,3662622,36,62,4.5,31,0.5,1,8.600555556,141.375,100.4193548,26,86.11111111111111,5
541,4889422,5,6,22,33,5430376,88,135,4.222222222,59,0.437037037,1,3.712222222,60.29,52.93220339,47,67.04545454545455,29
542,4887499,1,6,10,43,5232037,36,355,4.2,21,0.05915493,1,5.0175,79.197,90.80952381,319,58.333333333333336,15
543,4881520,2,6,9,27,4976658,63,93,4.5,51,0.548387097,1,13.10277778,233.297,102.0784314,30,80.95238095238095,12
544,4876106,5,6,20,48,4070112,52,86,4.5882352939999995,32,0.37209302299999997,1,5.681388889,137.41,104.875,34,61.53846153846154,20
545,4872729,2,6,10,12,3505505,53,110,4.481481481,47,0.427272727,1,12.32055556,198.582,96.53191489,57,88.67924528301887,6
546,4868970,1,6,19,7,5374755,72,139,4.3636363639999995,54,0.388489209,1,15.85583333,274.29200000000003,109.9814815,67,75.0,18
547,4868471,3,6,18,47,5067588,98,123,4.310344828,68,0.552845528,1,21.69611111,320.27099999999996,102.0882353,25,69.38775510204081,30
548,4868253,5,6,11,47,3638848,55,250,4.5,39,0.156,1,16.35833333,279.29900000000004,141.9230769,195,70.9090909090909,16
549,4867753,2,6,6,49,4358566,55,130,4.608695652,36,0.276923077,1,7.801666667,159.27100000000002,98.52777778,75,65.45454545454545,19
550,4856723,5,6,14,23,4172842,39,164,4.65,29,0.176829268,1,8.039722222,132.632,103.03448279999999,125,74.35897435897436,10
551,4835217,2,6,9,46,4707081,37,60,4.666666667,24,0.4,1,6.004722222000001,102.807,97.625,23,64.86486486486487,13
552,4834241,6,6,17,52,4937145,147,265,4.179104478,110,0.41509434,1,31.6375,564.971,110.3363636,118,74.82993197278913,37
553,4826928,5,6,21,10,3493100,58,141,4.45,40,0.283687943,1,11.11,214.76,116.175,83,68.96551724137932,18
554,4825983,2,6,20,22,5208987,57,186,4.19047619,41,0.220430108,1,11.32138889,206.479,109.5853659,129,71.9298245614035,16
555,4824444,3,6,16,4,3791646,49,173,3.615384615,19,0.10982659,1,4.2525,60.605,81.36842105,124,38.775510204081634,30
556,4810079,1,6,13,3,5326318,36,110,4.615384615,24,0.218181818,1,5.7536111110000006,108.491,102.54166670000001,74,66.66666666666666,12
557,4798667,7,6,17,16,4205094,46,114,4.571428571,38,0.333333333,1,9.275833333,197.30200000000002,114.23684209999999,68,82.6086956521739,8
558,4766432,4,6,18,43,4043345,17,96,4.555555556,13,0.135416667,1,3.935277778,58.883,103.07692309999999,79,76.47058823529412,4
559,4759527,4,6,9,54,4393514,108,155,4.170731707,85,0.548387097,1,20.64583333,374.665,97.37647059,47,78.70370370370371,23
560,4751636,5,6,16,4,5367198,53,245,4.4,43,0.17551020399999998,1,12.11861111,155.762,86.69767442,192,81.13207547169812,10
561,4748299,4,6,14,42,3227250,129,235,4.3125,31,0.131914894,1,4.846111111,107.035,85.29032258,106,24.031007751937985,98
562,4747243,2,6,21,18,4749633,33,68,4.222222222,17,0.25,1,2.972222222,60.981,93.52941176,35,51.515151515151516,16
563,4746093,2,6,17,12,4434096,65,176,4.4,46,0.261363636,1,15.57722222,292.115,127.9130435,111,70.76923076923077,19
564,4746082,3,6,16,24,5122653,57,157,4.2173913039999995,48,0.30573248399999997,1,12.43416667,187.12099999999998,89.875,100,84.21052631578947,9
565,4745683,1,6,9,57,4775564,23,162,2.0,5,0.030864198,1,1.235,20.249000000000002,99.4,139,21.73913043478261,18
566,4742252,4,6,18,19,4943540,78,121,4.206896552,54,0.44628099200000004,1,12.46277778,269.88,113.7222222,43,69.23076923076923,24
567,4740322,7,6,14,10,3481302,49,130,4.153846154,26,0.2,1,6.017222222000001,114.387,98.69230769,81,53.06122448979592,23
568,4735627,2,6,17,31,5252141,43,103,4.4,36,0.34951456299999994,1,13.90583333,190.342,111.6111111,60,83.72093023255815,7
569,4734526,3,6,13,58,3968592,81,111,4.230769231,65,0.585585586,1,17.91416667,316.545,106.24615379999999,30,80.24691358024691,16
570,4724083,4,6,19,7,5109473,37,113,4.272727273,18,0.159292035,1,3.411388889,67.197,89.72222222,76,48.64864864864865,19
571,4719213,4,6,15,11,4994670,35,70,4.555555556,17,0.242857143,1,4.071388889,78.465,106.0,35,48.57142857142857,18
572,4717605,4,6,21,51,3055456,56,65,4.1111111110000005,37,0.569230769,1,8.905833333,181.637,106.1891892,9,66.07142857142857,19
573,4715881,3,6,17,39,4796745,47,118,4.5882352939999995,43,0.36440678,1,11.43305556,227.37,114.1860465,71,91.48936170212765,4
574,4712098,2,6,23,25,5010056,43,140,4.277777778,31,0.22142857100000002,1,8.457222222,168.84599999999998,118.87096770000001,97,72.09302325581395,12
575,4704370,1,6,11,4,3583987,35,73,4.25,26,0.356164384,1,7.289166667000001,115.221,100.5384615,38,74.28571428571429,9
576,4703938,7,6,15,53,3926601,49,88,4.470588235,33,0.375,1,9.252222222,173.829,111.8484848,39,67.3469387755102,16
577,4699156,2,6,13,31,4851044,39,136,4.1363636360000005,36,0.264705882,1,9.723333333,158.822,99.27777778,97,92.3076923076923,3
578,4698073,5,6,9,1,4975696,30,57,4.625,28,0.49122807,1,7.885555556,139.1,107.1071429,27,93.33333333333333,2
579,4692537,4,6,16,13,5100051,64,78,4.55,44,0.564102564,1,10.25861111,221.239,113.4772727,14,68.75,20
580,4692530,3,6,16,51,4100505,49,187,4.130434783,40,0.213903743,1,11.55416667,193.13400000000001,108.35,138,81.63265306122449,9
581,4691104,5,6,11,36,3764423,136,179,4.45,87,0.48603352,1,24.55944444,459.94800000000004,112.4252874,43,63.970588235294116,49
582,4678371,2,6,8,13,3234520,88,235,4.090909091,47,0.2,1,10.52972222,230.99599999999998,108.3404255,147,53.40909090909091,41
583,4671798,7,6,14,28,5110427,48,98,4.3571428569999995,33,0.336734694,1,1.477777778,43.931000000000004,59.66666667,50,68.75,15
584,4666083,7,6,11,41,4188864,39,385,4.375,20,0.051948052,1,7.555277778,148.77200000000002,144.95,346,51.28205128205128,19
585,4658363,3,6,17,50,4514746,11,76,4.6,7,0.092105263,1,2.426388889,31.754,100.1428571,65,63.63636363636363,4
586,4649420,7,6,19,27,3993964,57,101,4.454545455,39,0.386138614,1,7.027777778,153.936,94.64102564,44,68.42105263157895,18
587,4643360,7,6,18,38,5423336,52,197,4.352941176,39,0.197969543,1,10.23611111,190.963,106.4871795,145,75.0,13
588,4638038,6,6,17,57,4951153,48,70,4.571428571,30,0.428571429,1,10.14222222,183.321,124.8,22,62.5,18
589,4633592,2,6,19,9,5358376,80,210,4.444444444,51,0.242857143,1,11.25416667,242.83,104.4705882,130,63.74999999999999,29
590,4632234,1,6,14,26,4973722,79,134,4.171428571,65,0.48507462700000004,1,17.98944444,334.15,109.96923079999999,55,82.27848101265823,14
591,4626846,1,6,11,41,5384217,85,158,4.0,66,0.417721519,1,21.75055556,391.398,121.42424240000001,73,77.64705882352942,19
592,4626074,4,6,10,37,4405251,58,125,4.35,41,0.32799999999999996,1,12.30138889,239.93099999999998,120.5365854,67,70.6896551724138,17
593,4625469,5,6,15,3,4650975,20,42,4.666666667,8,0.19047619,1,2.474166667,40.349000000000004,105.5,22,40.0,12
594,4612459,4,6,21,33,4283167,51,100,4.5,33,0.33,1,5.406388889,109.74799999999999,83.63636364,49,64.70588235294117,18
595,4605659,5,6,14,34,4757269,38,50,4.25,8,0.16,1,1.7238888890000001,28.294,86.375,12,21.052631578947366,30
596,4600591,7,6,18,13,5368768,71,114,4.517241379,54,0.473684211,1,11.29583333,240.733,100.0185185,43,76.05633802816901,17
597,4592166,7,6,14,16,4904376,79,195,4.1428571430000005,68,0.34871794899999997,1,18.8525,348.74800000000005,108.88235290000001,116,86.07594936708861,11
598,4585923,2,6,9,42,5305967,113,164,4.2826086960000005,83,0.506097561,1,18.98388889,340.269,96.33734940000001,51,73.45132743362832,30
599,4579092,3,6,20,33,4319759,46,102,4.454545455,38,0.37254902,1,8.424444444,203.592,112.57894740000002,56,82.6086956521739,8
600,4577172,1,6,11,34,4580033,37,146,4.625,28,0.191780822,1,5.756666667,97.785,83.53571429,109,75.67567567567568,9
601,4572050,3,6,12,13,5270650,72,119,4.090909091,47,0.39495798299999996,1,10.77861111,194.699,93.74468085,47,65.27777777777779,25
602,4571534,3,6,12,20,5073572,92,207,4.3142857139999995,70,0.338164251,1,19.12888889,324.394,102.4857143,115,76.08695652173914,22
603,4571158,5,6,11,14,4555681,62,92,4.25,27,0.293478261,1,3.8325,75.727,75.11111111,30,43.54838709677419,35
604,4565655,7,6,17,42,4695318,22,118,4.615384615,19,0.161016949,1,6.526388889,102.93299999999999,115.1052632,96,86.36363636363636,3
605,4554374,5,6,18,20,5423842,48,118,4.421052632,37,0.313559322,1,8.603611111000001,164.702,103.972973,70,77.08333333333334,11
606,4552639,5,6,8,47,3941712,35,246,5.0,8,0.032520325,1,1.331111111,29.521,92.625,211,22.857142857142858,27
607,4541864,1,6,11,25,4514116,38,120,4.307563701,2,0.016666667,1,0.186944444,7.881,93.0,82,5.263157894736842,36
608,4541499,5,6,10,17,4296998,58,138,4.272727273,44,0.31884058,1,11.94083333,212.64,106.45454550000001,80,75.86206896551724,14
609,4540772,5,6,13,28,4389756,91,113,4.088888889,81,0.716814159,1,20.56166667,351.756,100.1234568,22,89.01098901098901,10
610,4525331,3,6,9,42,4961917,84,128,4.576923077,67,0.5234375,1,21.67555556,337.566,108.19402990000002,44,79.76190476190477,17
611,4514439,3,6,15,55,3899581,78,172,4.5,48,0.27906976699999997,1,10.43055556,213.22799999999998,101.64583329999999,94,61.53846153846154,30
612,4510572,1,6,14,5,4632958,31,72,4.6,23,0.319444444,1,5.085555556,104.131,105.0,41,74.19354838709677,8
613,4510388,3,6,10,0,3191381,50,70,4.1111111110000005,32,0.457142857,1,3.556388889,58.336000000000006,59.1875,20,64.0,18
614,4489028,4,6,20,49,5062369,31,148,4.3,16,0.10810810800000001,1,3.856666667,83.411,112.375,117,51.61290322580645,15
615,4487711,7,6,15,5,3054098,9,41,4.0,9,0.219512195,1,2.2475,35.775,92.66666667,32,100.0,0
616,4487064,1,6,18,57,5396533,68,168,4.230769231,46,0.27380952399999997,1,14.71444444,229.042,105.0869565,100,67.64705882352942,22
617,4486426,4,6,13,51,4851762,54,146,4.25,40,0.273972603,1,11.48972222,209.077,111.475,92,74.07407407407408,14
618,4479381,7,6,20,32,4600349,35,44,3.7,30,0.681818182,1,7.583611111000001,130.225,98.4,9,85.71428571428571,5
619,4478130,5,6,8,25,5416081,47,64,4.423076923,45,0.703125,1,12.42555556,192.32299999999998,97.6,17,95.74468085106383,2
620,4473842,3,6,17,58,4480685,30,82,4.625,22,0.26829268300000003,1,5.573888889,120.74600000000001,114.1363636,52,73.33333333333333,8
621,4472358,7,6,18,30,5181343,126,170,4.326923077,89,0.523529412,1,23.44583333,456.923,110.59550559999998,44,70.63492063492063,37
622,4468616,2,6,13,47,4868993,29,98,3.0,3,0.030612245,1,0.009722221999999999,10.118,87.0,69,10.344827586206897,26
623,4465138,5,6,20,12,3481302,64,284,4.75,13,0.045774648,1,1.943055556,51.233999999999995,95.23076923,220,20.3125,51
624,4464698,3,6,18,48,4765740,29,247,4.4,18,0.072874494,1,1.963055556,35.218,63.44444444,218,62.06896551724138,11
625,4464332,2,6,8,38,4949730,97,196,4.222222222,73,0.37244898,1,23.05833333,384.51199999999994,112.7808219,99,75.25773195876289,24
626,4450505,4,6,14,49,5419377,47,108,4.619047619,36,0.333333333,1,10.27444444,176.87099999999998,108.44444440000001,61,76.59574468085107,11
627,4445887,2,6,18,23,4728764,12,65,4.0,5,0.076923077,1,2.024722222,37.189,142.0,53,41.66666666666667,7
628,4444577,3,6,11,35,5118173,87,208,4.171428571,74,0.355769231,1,23.50138889,425.346,120.1756757,121,85.0574712643678,13
629,4434650,3,6,19,33,3770422,43,120,3.8181818180000002,18,0.15,1,2.465,67.464,91.83333333,77,41.86046511627907,25
630,4424797,4,6,6,51,3516865,59,136,4.210526316,40,0.294117647,1,12.86777778,150.963,89.325,77,67.79661016949152,19
631,4413887,5,6,14,12,3763268,23,57,4.166666667,23,0.403508772,1,8.946388889,118.116,110.0434783,34,100.0,0
632,4408332,4,6,17,8,5106871,73,122,4.333333333,65,0.532786885,1,19.54638889,329.296,111.12307690000002,49,89.04109589041096,8
633,4384381,3,6,11,45,4971511,21,87,4.4,9,0.10344827599999999,1,2.476944444,35.111,94.11111111,66,42.857142857142854,12
634,4373795,7,6,13,56,5330850,16,72,4.2,10,0.13888888900000002,1,3.0125,50.066,109.5,56,62.5,6
635,4372392,7,6,17,19,3988254,81,93,4.37037037,62,0.666666667,1,14.13305556,320.406,116.93548390000001,12,76.5432098765432,19
636,4364901,3,6,18,2,3426419,18,101,4.571428571,10,0.099009901,1,0.531944444,25.156999999999996,75.7,83,55.55555555555556,8
637,4346771,1,6,16,17,4988745,60,82,4.485714286,58,0.707317073,1,11.62916667,236.58599999999998,92.67241379,22,96.66666666666667,2
638,4335274,1,6,9,22,4551811,10,114,4.5,7,0.061403509,1,2.155555556,31.948,101.7142857,104,70.0,3
639,4303751,3,6,17,25,4815234,78,154,4.461538462,29,0.188311688,1,8.388611111,134.21200000000002,103.82758620000001,76,37.17948717948718,49
640,4301381,1,6,16,14,4549187,56,164,4.384615385,23,0.140243902,1,6.811111111000001,106.14399999999999,104.173913,108,41.07142857142857,33
641,4295655,5,6,19,3,4974184,63,169,4.1428571430000005,27,0.15976331400000002,1,7.586111111,150.21200000000002,118.0,106,42.857142857142854,36
642,4282958,1,6,9,6,4841152,59,115,4.214285714,36,0.313043478,1,9.351111111,155.261,96.97222222,56,61.016949152542374,23
643,4264734,3,6,21,58,4686854,110,154,4.470588235,76,0.49350649399999996,1,19.07472222,357.246,104.6710526,44,69.0909090909091,34
644,4236070,5,6,17,25,4721178,35,107,4.3888888889999995,30,0.280373832,1,8.613333333,126.16799999999999,93.2,72,85.71428571428571,5
645,4236063,7,6,18,39,5085766,54,68,4.555555556,39,0.5735294120000001,1,7.475833333,172.352,106.4102564,14,72.22222222222221,15
646,4233720,4,6,9,55,4778778,42,144,4.6,19,0.131944444,1,4.898611111,87.118,100.0,102,45.23809523809524,23
647,4233558,7,6,13,1,4549226,63,238,4.64516129,48,0.201680672,1,14.31166667,265.676,116.04166670000001,175,76.19047619047619,15
648,4228298,7,6,14,26,5399552,66,155,5.0,5,0.032258065,1,1.0169444440000002,18.072,84.6,89,7.575757575757576,61
649,4215795,5,6,17,37,5350230,75,84,4.689655172,59,0.7023809520000001,1,18.25555556,326.677,117.71186440000001,9,78.66666666666666,16
650,4212318,5,6,9,25,5335633,24,65,4.333333333,15,0.23076923100000002,1,4.425833333,64.571,96.13333333,41,62.5,9
651,4204467,3,6,9,21,5032576,18,35,4.5,7,0.2,1,1.5363888890000001,24.421999999999997,89.0,17,38.88888888888889,11
652,4153934,1,6,14,47,3898959,55,85,4.0869565219999995,39,0.458823529,1,10.87055556,165.982,98.58974359,30,70.9090909090909,16
653,4148928,7,6,23,0,4035417,25,81,4.285714286,13,0.160493827,1,3.038888889,47.185,87.38461538,56,52.0,12
654,4112672,5,6,11,53,4867812,26,100,4.4,9,0.09,1,1.794444444,26.28,76.22222222,74,34.61538461538461,17
655,4110740,6,6,9,42,4980188,39,74,4.5,15,0.202702703,1,4.737777778,96.82700000000001,128.46666670000002,35,38.46153846153847,24
656,4052610,2,6,18,59,4398640,44,162,4.375,31,0.191358025,1,6.751666667,131.571,97.03225806,118,70.45454545454545,13
657,4035678,4,6,11,1,4001426,36,46,3.75,27,0.586956522,1,7.675833333,142.74200000000002,109.85185190000001,10,75.0,9
658,4034589,7,6,20,4,4883739,45,165,3.923076923,27,0.163636364,1,6.877222222,118.771,106.4814815,120,60.0,18
659,4028017,6,6,14,53,5397504,60,96,4.3636363639999995,43,0.44791666700000005,1,6.622777778,123.896,77.37209302,36,71.66666666666667,17
660,4027965,5,6,19,41,4977748,35,60,4.4,28,0.46666666700000003,1,6.072222222000001,118.01299999999999,96.78571429,25,80.0,7
661,4027413,7,6,14,20,4128048,65,195,4.695652174,32,0.164102564,1,9.772777778,205.612,137.375,130,49.23076923076923,33
662,4021572,2,6,15,38,4536964,65,121,4.25,39,0.32231405,1,8.938611111,179.74900000000002,103.6923077,56,60.0,26
663,4012859,3,6,17,55,5068974,71,354,3.666666667,20,0.056497175,1,5.939166667,94.146,102.2,283,28.169014084507044,51
664,3980110,4,6,18,21,4761024,22,119,3.833333333,14,0.117647059,1,4.237777778,62.538000000000004,104.8571429,97,63.63636363636363,8
665,3952989,7,6,6,49,3522510,40,79,4.666666667,22,0.278481013,1,4.985555556,72.913,82.77272727,39,55.00000000000001,18
666,3951792,2,6,9,26,4322127,108,147,4.205128205,74,0.503401361,1,19.02027778,361.31,118.6756757,39,68.51851851851852,34
667,3946079,1,6,8,6,5384113,60,142,3.923076923,33,0.23239436600000002,1,9.170277777999999,135.24,94.39393939,82,55.00000000000001,27
668,3936971,2,6,9,47,5325454,29,211,5.0,8,0.037914692,1,2.141944444,37.696999999999996,106.75,182,27.586206896551722,21
669,3936119,1,6,7,19,4512835,191,378,4.209302326,101,0.267195767,1,27.31972222,534.73,110.990099,187,52.879581151832454,90
670,3916755,1,6,10,29,4276871,35,57,4.454545455,22,0.38596491200000005,1,5.8088888889999994,100.139,101.31818179999999,22,62.857142857142854,13
671,3896826,3,6,9,48,4363840,99,206,4.380952381,42,0.203883495,1,10.25888889,167.27599999999998,93.64285714,107,42.42424242424242,57
672,3887018,1,6,16,49,5310790,58,85,4.421052632,46,0.541176471,1,13.62222222,200.46,97.71739129999999,27,79.3103448275862,12
673,3864586,2,6,16,38,4564848,46,220,3.285714286,10,0.045454545,1,1.9452777780000001,28.943,79.4,174,21.73913043478261,36
674,3854963,5,6,6,45,4987531,59,260,4.458333333,44,0.16923076899999998,1,9.870555556000001,197.782,99.84090909,201,74.57627118644068,15
675,3837162,2,6,9,45,4064943,78,189,4.47826087,47,0.248677249,1,15.76111111,263.434,117.10638300000001,111,60.256410256410255,31
676,3804886,2,6,10,34,5263268,70,163,4.464285714,48,0.294478528,1,15.85,231.09400000000002,103.97916670000001,93,68.57142857142857,22
677,3772692,3,6,4,42,5408281,52,97,4.208333333,39,0.402061856,1,10.25527778,171.597,101.8205128,45,75.0,13
678,3751577,3,6,10,56,5047747,49,188,4.307692308,36,0.191489362,1,10.16138889,187.847,112.7777778,139,73.46938775510205,13
679,3738000,3,6,15,45,3776070,19,132,3.833333333,10,0.075757576,1,1.8958333330000001,52.826,118.4,113,52.63157894736842,9
680,3718344,2,6,21,54,4830383,47,92,4.6875,30,0.326086957,1,6.169722222000001,137.415,105.66666670000001,45,63.829787234042556,17
681,3717245,4,6,10,52,3577566,91,128,4.59375,69,0.5390625,1,18.35777778,282.591,95.44927536,37,75.82417582417582,22
682,3709813,2,6,22,38,5291399,42,109,4.3,30,0.27522935800000004,1,7.361388889,131.018,121.53333329999998,67,71.42857142857143,12
683,3698459,3,6,15,29,4635106,104,131,4.075,81,0.618320611,1,21.75055556,386.11800000000005,104.1975309,27,77.88461538461539,23
684,3646812,7,6,14,54,4513832,54,234,4.692307692,37,0.158119658,1,7.420555556,138.976,88.91891892,180,68.51851851851852,17
685,3645038,1,6,19,1,4456862,12,135,5.0,4,0.02962963,1,0.9894444440000001,15.511,89.75,123,33.33333333333333,8
686,3638664,3,6,21,1,4720448,48,175,4.444444444,36,0.20571428600000002,1,11.36583333,214.217,126.2777778,127,75.0,12
687,3637101,1,6,10,32,4215439,24,77,4.0,10,0.12987013,1,1.474444444,32.076,80.9,53,41.66666666666667,14
688,3634447,5,6,21,36,5428208,69,104,4.655172414,47,0.451923077,1,10.74777778,221.107,109.8510638,35,68.11594202898551,22
689,3550359,2,6,10,21,5158077,70,155,4.413793103,53,0.341935484,1,10.36777778,216.146,97.07547170000001,85,75.71428571428571,17
690,3527160,4,6,17,30,3091801,71,144,4.333333333,54,0.375,1,6.39,118.212,66.74074074,73,76.05633802816901,17
691,3481158,3,6,13,23,4319383,85,149,4.074074073999999,72,0.483221477,1,21.63444444,356.723,106.7638889,64,84.70588235294117,13
692,3475712,6,6,8,39,5290325,78,301,4.161290323,48,0.15946843900000002,1,11.60333333,223.252,104.1875,223,61.53846153846154,30
693,3459818,2,6,10,51,4412719,70,108,3.789473684,38,0.351851852,1,9.311388889,159.06,97.39473684,38,54.285714285714285,32
694,3452591,2,6,19,20,4946356,37,66,4.263157895,28,0.424242424,1,7.106944444,138.102,106.8928571,29,75.67567567567568,9
695,3442931,4,6,21,53,4721722,86,146,4.5,38,0.260273973,1,12.17972222,212.37099999999998,123.0263158,60,44.18604651162791,48
696,3419580,7,6,18,15,4791762,43,240,3.833333333,14,0.058333333,1,3.798611111,53.321999999999996,93.28571429,197,32.55813953488372,29
697,3399291,4,6,10,54,5330988,33,95,3.5,3,0.031578947,1,0.278888889,4.475,55.66666667,62,9.090909090909092,30
698,3360438,7,6,16,3,4945116,34,59,4.090909091,27,0.45762711899999997,1,7.436111111000001,96.78200000000001,87.48148148,25,79.41176470588235,7
699,3243415,1,6,9,31,4484351,53,385,4.333333333,24,0.062337662,1,3.978333333,71.163,74.95833333,332,45.28301886792453,29
700,3226970,1,6,9,19,3354199,45,107,4.214285714,28,0.261682243,1,5.592222222,113.37200000000001,93.42857143,62,62.22222222222222,17
701,3218143,4,6,9,39,3906220,25,368,5.0,7,0.019021739,1,1.424166667,30.318,98.57142857,343,28.000000000000004,18
702,3143007,5,6,6,43,3979189,110,214,4.333333333,93,0.434579439,1,24.63333333,482.906,116.4193548,104,84.54545454545455,17
703,3110182,2,6,21,30,4716039,45,208,4.0,25,0.12019230800000001,1,7.437777777999999,147.32,123.88,163,55.55555555555556,20
704,3109117,2,6,14,0,4464862,37,76,4.1111111110000005,25,0.328947368,1,6.299722222000001,137.793,117.32,39,67.56756756756756,12
705,2969346,4,6,9,47,4566054,39,76,4.166666667,13,0.17105263199999998,1,2.229444444,44.347,83.23076923,37,33.33333333333333,26
706,2957882,7,6,12,47,4575731,81,143,4.424242424,63,0.440559441,1,13.55972222,271.608,98.53968254,62,77.77777777777779,18
707,2950628,5,6,9,41,4513270,8,57,3.0,7,0.122807018,1,1.721388889,22.699,79.71428571,49,87.5,1
708,2950226,2,6,12,10,4527127,68,190,4.307692308,53,0.27894736800000003,1,15.78194444,240.19099999999997,100.0188679,122,77.94117647058823,15
709,2940838,1,6,13,0,5210702,50,125,4.5882352939999995,37,0.29600000000000004,1,9.130555556000001,147.97299999999998,92.27027027,75,74.0,13
710,2931712,6,6,9,48,4985526,16,314,4.6,6,0.01910828,1,1.8875,28.884,108.33333329999999,298,37.5,10
711,2895351,3,6,10,56,5387628,96,118,4.5806451610000005,78,0.661016949,1,19.84944444,367.691,104.83333329999999,22,81.25,18
712,2894948,4,6,9,54,3490350,44,358,4.555555556,33,0.09217877099999999,1,10.275,185.18099999999998,118.21212120000001,314,75.0,11
713,2894871,1,6,10,18,4945432,63,131,4.6,37,0.282442748,1,10.33861111,190.003,110.0810811,68,58.730158730158735,26
714,2886584,4,6,21,3,4851288,58,189,4.606060606000001,53,0.28042328,1,12.56305556,265.841,111.96226419999999,131,91.37931034482759,5
715,2870173,2,6,17,14,4519887,49,285,4.25,19,0.066666667,1,4.008888889,71.02,89.26315789,236,38.775510204081634,30
716,5413087,3,5,19,43,5021979,16,199,4.4,11,0.055276382,1,3.2580555560000004,48.003,99.0,183,68.75,5
717,5412886,7,5,18,2,3963221,60,165,4.518518519,44,0.26666666699999997,1,13.64916667,226.205,111.6136364,105,73.33333333333333,16
718,5412726,6,5,20,18,3856975,19,80,3.9,16,0.2,1,2.8988888889999997,67.403,101.3125,61,84.21052631578947,3
719,5412139,5,5,14,33,5142936,17,64,3.8,9,0.140625,1,2.345555556,27.826999999999998,82.22222222,47,52.94117647058824,8
720,5412026,6,5,17,43,5057655,58,284,4.714285714,31,0.10915493,1,2.8816666669999997,58.03,66.12903226,226,53.44827586206896,27
721,5412014,7,5,10,26,3769866,29,59,4.272727273,22,0.372881356,1,3.952777778,80.396,91.22727273,30,75.86206896551724,7
722,5411571,4,5,20,27,5200294,94,120,4.348837209,74,0.6166666670000001,1,17.48444444,328.49300000000005,99.44594595,26,78.72340425531915,20
723,5411546,6,5,8,43,4864892,49,94,4.352941176,34,0.36170212799999996,1,11.91333333,165.387,109.6764706,45,69.38775510204081,15
724,5410655,5,5,13,48,5171954,102,187,3.96875,61,0.326203209,1,14.20611111,286.95,105.2131148,85,59.80392156862745,41
725,5410635,3,5,23,59,4261516,29,164,4.5,13,0.079268293,1,3.7177777780000003,48.196000000000005,101.38461540000002,135,44.827586206896555,16
726,5405478,5,5,12,57,3134345,20,58,4.5,14,0.24137931,1,5.454722222000001,74.164,112.2142857,38,70.0,6
727,5405146,5,5,8,24,5030834,22,59,4.0,15,0.254237288,1,3.405833333,76.295,109.8,37,68.18181818181817,7
728,5404933,4,5,9,0,5043433,54,112,4.566666667,46,0.41071428600000004,1,12.92472222,233.139,108.52173909999998,58,85.18518518518519,8
729,5404904,7,5,9,23,4660137,26,182,4.0,6,0.032967033,1,5.209444444,25.206999999999997,102.83333329999999,156,23.076923076923077,20
730,5404891,4,5,9,38,4899397,39,56,4.7,37,0.660714286,1,9.170555556,180.15900000000002,103.1891892,17,94.87179487179486,2
731,5404301,7,5,19,47,4078048,28,91,4.428571429,21,0.23076923100000002,1,5.407222222000001,88.15,97.80952381,63,75.0,7
732,5404262,5,5,17,7,4552782,69,174,4.68,55,0.316091954,1,12.56833333,242.56099999999998,99.65454545,105,79.71014492753623,14
733,5404192,4,5,13,6,5327063,35,227,4.909090909,23,0.10132158599999999,1,7.659722222,120.83200000000001,114.17391299999998,192,65.71428571428571,12
734,5403816,7,5,15,55,3073677,44,130,4.8,16,0.123076923,1,4.5433333330000005,75.491,105.6875,86,36.36363636363637,28
735,5402543,7,5,17,25,4245725,40,60,3.6875,30,0.5,1,7.646944444,120.93,96.06666667,20,75.0,10
736,5402459,5,5,9,24,3948091,42,87,4.727272727,24,0.275862069,1,6.751388888999999,106.637,102.08333329999999,45,57.14285714285714,18
737,5400286,5,5,10,37,3526394,107,135,4.148148148,57,0.42222222200000004,1,16.3375,305.138,113.9122807,28,53.271028037383175,50
738,5396443,5,5,10,24,4078737,49,78,4.608695652,43,0.551282051,1,10.88333333,167.24400000000003,93.65116279,29,87.75510204081633,6
739,5396363,2,5,13,0,3863432,38,85,4.0,20,0.235294118,1,5.7247222220000005,99.90299999999999,107.95,47,52.63157894736842,18
740,5396318,7,5,15,17,4391856,38,101,4.266666667,26,0.257425743,1,5.546666667,116.779,103.07692309999999,63,68.42105263157895,12
741,5396299,2,5,16,16,3761347,23,98,4.1,15,0.153061224,1,4.8125,66.755,101.8666667,75,65.21739130434783,8
742,5395238,2,5,14,27,3991022,21,73,4.222222222,12,0.16438356199999998,1,1.770555556,34.482,76.75,52,57.14285714285714,9
743,5395225,5,5,17,28,5426703,78,130,4.035714286,62,0.47692307700000003,1,14.99888889,262.95599999999996,97.37096774,52,79.48717948717949,16
744,5394706,3,5,19,21,5041638,22,94,4.0,12,0.127659574,1,3.370833333,45.56100000000001,89.58333333,72,54.54545454545454,10
745,5391862,5,5,18,13,4418854,25,67,4.272727273,18,0.268656716,1,2.73,72.821,96.83333333,42,72.0,7
746,5389748,4,5,15,23,4604039,22,142,4.571428571,16,0.112676056,1,3.01,45.549,75.125,120,72.72727272727273,6
747,5388919,2,5,7,27,4098016,58,138,4.181818182,43,0.311594203,1,11.51666667,186.12400000000002,98.88372093,80,74.13793103448276,15
748,5388711,4,5,16,59,4180407,45,162,4.666666667,29,0.17901234600000002,1,7.674444444,124.462,97.48275862,117,64.44444444444444,16
749,5388303,3,5,19,32,5085508,50,180,4.5,22,0.12222222199999999,1,5.42,119.552,116.1363636,130,44.0,28
750,5387865,5,5,17,44,5326572,32,104,4.416666667,25,0.240384615,1,8.067222222,140.54399999999998,116.52,72,78.125,7
751,5387569,4,5,22,3,3381725,14,34,4.5,12,0.352941176,1,3.2061111110000002,65.66199999999999,125.33333329999999,20,85.71428571428571,2
752,5383391,4,5,9,56,4900753,36,52,4.466666667,29,0.557692308,1,8.869722222,154.503,114.2413793,16,80.55555555555556,7
753,5383323,7,5,22,33,5444058,31,81,4.923076923,26,0.320987654,1,5.229166667,110.12700000000001,100.8461538,50,83.87096774193549,5
754,5382990,1,5,10,36,4559628,30,100,3.666666667,26,0.26,1,6.7863888889999995,118.84100000000001,100.8461538,70,86.66666666666667,4
755,5382185,4,5,9,32,5224345,52,117,4.578947368,40,0.341880342,1,12.83333333,189.893,104.175,65,76.92307692307693,12
756,5381846,3,5,17,46,4989875,33,85,4.0,24,0.282352941,1,5.345277778,96.78,96.20833333,52,72.72727272727273,9
757,5374817,5,5,17,16,5098791,39,76,4.4,27,0.35526315799999997,1,6.865833332999999,98.65700000000001,88.2962963,37,69.23076923076923,12
758,5374235,5,5,12,17,4815813,27,122,4.75,20,0.163934426,1,8.612777778,148.377,144.8,95,74.07407407407408,7
759,5374110,2,5,11,27,5240212,116,318,4.5,29,0.091194969,1,9.800555556,150.861,111.2758621,202,25.0,87
760,5373515,6,5,8,17,4672286,55,95,4.125,40,0.42105263200000004,1,11.67805556,181.725,103.45,40,72.72727272727273,15
761,5373431,7,5,13,35,4627232,54,103,4.052631579,37,0.359223301,1,11.93944444,169.27700000000002,102.37837840000002,49,68.51851851851852,17
762,5368290,1,5,20,34,4678491,29,92,4.3636363639999995,21,0.22826087,1,4.358333333,96.495,104.57142859999999,63,72.41379310344827,8
763,5364223,1,5,20,23,4525761,23,142,4.0,12,0.08450704199999999,1,3.1325,55.162,102.91666670000001,119,52.17391304347826,11
764,5364132,1,5,18,2,5024890,32,96,4.1,20,0.208333333,1,7.4852777779999995,135.621,141.8,64,62.5,12
765,5361881,2,5,20,8,4680522,16,85,3.857142857,9,0.10588235300000001,1,1.628611111,27.283,77.33333333,69,56.25,7
766,5361666,4,5,18,45,4702125,21,51,4.5,12,0.235294118,1,3.9975,86.955,139.58333330000002,30,57.14285714285714,9
767,5361421,1,5,20,57,5329794,28,34,4.4,26,0.764705882,1,5.464444444,124.691,112.5384615,6,92.85714285714286,2
768,5361234,2,5,18,15,5373363,31,44,4.133333333,23,0.522727273,1,6.159444444,58.13399999999999,73.56521739,13,74.19354838709677,8
769,5360441,5,5,9,1,4744125,31,49,4.333333333,20,0.408163265,1,5.364444444,88.18700000000001,100.8,18,64.51612903225806,11
770,5360321,5,5,20,40,4545177,41,149,4.25,27,0.18120805399999998,1,7.761666667,148.001,118.03703700000001,108,65.85365853658537,14
771,5359844,2,5,15,52,4242333,32,98,4.181818182,17,0.173469388,1,6.3211111110000004,97.509,122.0,66,53.125,15
772,5356175,7,5,13,2,5376272,15,53,4.0,9,0.16981132100000002,1,2.601666667,46.161,109.0,38,60.0,6
773,5354936,5,5,10,21,5093998,14,56,4.5,10,0.17857142899999998,1,2.695833333,39.128,92.8,42,71.42857142857143,4
774,5354650,4,5,17,32,5258948,46,163,3.952380952,39,0.239263804,1,10.76416667,170.861,98.15384615,117,84.78260869565217,7
775,5354603,4,5,20,54,5041811,54,86,4.2,27,0.313953488,1,5.595555556,115.155,97.07407407,32,50.0,27
776,5353917,1,5,9,34,4518419,34,118,4.222222222,17,0.144067797,1,6.296111111,101.48100000000001,144.0,84,50.0,17
777,5353449,2,5,10,25,4758298,31,55,4.25,20,0.363636364,1,5.683611111,109.71600000000001,116.3,24,64.51612903225806,11
778,5352833,7,5,16,2,4670115,21,37,4.25,14,0.37837837799999996,1,3.7430555560000003,50.876000000000005,85.64285714,16,66.66666666666666,7
779,5352096,7,5,20,33,4503798,41,132,4.25,33,0.25,1,7.871666667,161.28,106.78787879999999,91,80.48780487804879,8
780,5348716,2,5,9,48,4699340,75,153,4.476190476,46,0.300653595,1,12.845,224.701,110.30434779999999,78,61.33333333333333,29
781,5348657,7,5,15,43,3831017,17,75,4.5,13,0.173333333,1,3.903333333,39.973,81.53846154,58,76.47058823529412,4
782,5348618,4,5,10,55,3971146,26,116,4.1111111110000005,20,0.172413793,1,6.0825,74.439,90.35,90,76.92307692307693,6
783,5348402,2,5,20,5,5093615,25,54,4.555555556,17,0.314814815,1,4.048888889,80.25,107.29411759999999,29,68.0,8
784,5347647,7,5,10,19,4812735,75,98,4.621621622,54,0.551020408,1,15.60416667,292.039,113.5185185,23,72.0,21
785,5347552,1,5,19,31,5146803,25,48,4.272727273,21,0.4375,1,5.497222222,134.36,127.0952381,23,84.0,4
786,5347462,5,5,16,8,5427118,63,68,4.32,49,0.720588235,1,11.72083333,229.44,100.77551020000001,5,77.77777777777779,14
787,5347209,2,5,9,46,5401848,48,49,4.454545455,43,0.87755102,1,12.01,199.953,101.9767442,1,89.58333333333334,5
788,5346917,5,5,22,34,5414932,54,60,4.6111111110000005,38,0.6333333329999999,1,9.611388889,205.54,143.9210526,6,70.37037037037037,16
789,5346380,1,5,11,7,4118621,14,55,2.25,10,0.181818182,1,2.775555556,61.75,131.9,41,71.42857142857143,4
790,5346362,4,5,13,36,5402530,62,179,4.210526316,36,0.20111731800000002,1,12.27694444,175.878,105.58333329999999,117,58.06451612903226,26
791,5346353,5,5,15,27,3300665,46,159,4.470588235,38,0.23899371100000003,1,11.81111111,184.271,105.31578950000001,113,82.6086956521739,8
792,5343369,2,5,19,19,5207969,64,113,4.083333333,47,0.415929204,1,16.23888889,251.06400000000002,113.1702128,49,73.4375,17
793,5341186,5,5,18,1,4133049,10,45,4.307563701,4,0.088888889,1,1.130277778,15.54,95.0,35,40.0,6
794,5340520,1,5,11,34,5187332,49,91,4.294117647,37,0.406593407,1,10.41777778,173.982,102.5945946,42,75.51020408163265,12
795,5340237,4,5,20,49,4079641,30,219,4.0,12,0.054794521,1,1.826944444,35.393,82.08333333,189,40.0,18
796,5339129,2,5,11,14,4763498,39,231,4.1875,29,0.125541126,1,7.709444444,127.35600000000001,98.96551724,192,74.35897435897436,10
797,5338870,7,5,17,53,3121765,30,90,3.571428571,20,0.222222222,1,4.939722221999999,89.305,99.6,60,66.66666666666666,10
798,5334162,4,5,16,1,3733782,42,206,4.176470588,25,0.121359223,1,6.203611111,103.226,93.52,164,59.523809523809526,17
799,5333721,1,5,9,6,3091099,91,155,4.341463415,74,0.477419355,1,19.83833333,314.65,96.08108108,64,81.31868131868131,17
800,5333448,4,5,21,49,4017602,34,50,4.230769231,26,0.52,1,4.0225,50.851000000000006,62.84615385,16,76.47058823529412,8
801,5333150,4,5,17,11,4997076,47,233,4.444444444,30,0.128755365,1,7.766388889,136.852,101.33333329999999,186,63.829787234042556,17
802,5332914,7,5,20,2,3888741,36,63,4.5,26,0.412698413,1,7.63,137.375,113.4615385,27,72.22222222222221,10
803,5332197,1,5,15,49,4697522,65,176,4.25,30,0.170454545,1,10.10166667,166.72099999999998,115.93333329999999,111,46.15384615384615,35
804,5331644,5,5,18,34,5046474,32,63,4.466666667,23,0.365079365,1,6.701944444,115.79299999999999,107.43478259999999,31,71.875,9
805,5327495,3,5,9,2,4771845,67,89,3.8125,50,0.561797753,1,15.51111111,252.611,111.58,22,74.6268656716418,17
806,5326516,3,5,16,1,4373691,49,112,4.3636363639999995,25,0.223214286,1,2.2475,76.85600000000001,85.92,63,51.02040816326531,24
807,5325471,2,5,15,34,5310790,85,97,4.475,68,0.701030928,1,19.8825,339.524,106.61764709999999,12,80.0,17
808,5325152,4,5,16,17,4944914,112,220,4.055555556,33,0.15,1,8.667777778,166.143,106.9393939,108,29.464285714285715,79
809,5325133,5,5,12,19,5189469,35,106,4.333333333,26,0.245283019,1,7.025,106.59,93.88461538,71,74.28571428571429,9
810,5324525,3,5,13,3,3069052,54,70,4.692307692,36,0.514285714,1,9.336944444,168.328,102.0555556,16,66.66666666666666,18
811,5323965,4,5,17,51,5173125,33,90,4.333333333,21,0.233333333,1,6.065277778,112.69,119.42857140000001,57,63.63636363636363,12
812,5319254,5,5,21,45,3669877,16,39,4.4,11,0.282051282,1,4.5422222219999995,55.512,111.6363636,23,68.75,5
813,5318550,5,5,19,9,4956835,21,82,4.666666667,18,0.219512195,1,2.7855555560000003,44.292,73.05555556,61,85.71428571428571,3
814,5318399,2,5,18,43,5350022,27,198,4.5,14,0.070707071,1,3.540555556,53.722,90.0,171,51.85185185185185,13
815,5317465,2,5,11,31,5225210,63,183,4.666666667,39,0.213114754,1,10.35638889,194.226,107.6410256,120,61.904761904761905,24
816,5316680,7,5,14,0,4680694,64,110,4.8,46,0.418181818,1,12.07777778,181.632,91.95652174,46,71.875,18
817,5316186,1,5,20,55,5081717,24,159,5.0,11,0.06918239,1,3.004722222,51.548,103.7272727,135,45.83333333333333,13
818,5312574,2,5,9,58,5301222,42,145,4.4,32,0.220689655,1,7.090555556,108.61,83.625,103,76.19047619047619,10
819,5312134,2,5,21,19,4714347,11,155,4.307563701,1,0.006451613,1,0.155277778,1.89,71.0,144,9.090909090909092,10
820,5312059,7,5,9,13,5286204,36,42,4.1428571430000005,29,0.69047619,1,7.0819444439999995,116.398,92.31034483,6,80.55555555555556,7
821,5311808,5,5,10,19,4798424,79,158,4.666666667,63,0.398734177,1,14.44527778,243.709,89.96825397,79,79.74683544303798,16
822,5311290,3,5,20,37,4286580,46,118,4.458333333,35,0.296610169,1,7.377777778,157.571,101.7142857,72,76.08695652173914,11
823,5310941,3,5,9,30,3684437,22,56,4.285714286,16,0.28571428600000004,1,5.279722222,72.774,101.4375,34,72.72727272727273,6
824,5310443,4,5,18,16,5400244,17,102,4.666666667,10,0.098039216,1,3.204444444,45.903999999999996,103.4,85,58.82352941176471,7
825,5309104,2,5,11,10,4933148,38,109,3.7,29,0.266055046,1,6.454444444,113.995,92.65517241,71,76.31578947368422,9
826,5305086,2,5,17,41,5198357,32,38,4.0,27,0.7105263159999999,1,4.175555556,83.82600000000001,82.88888889,6,84.375,5
827,5305045,4,5,21,3,5342786,17,99,4.285714286,14,0.141414141,1,4.6225,83.499,129.7857143,82,82.35294117647058,3
828,5304780,5,5,17,8,3345891,20,67,4.777777778,12,0.179104478,1,3.630277778,57.678999999999995,103.16666670000001,47,60.0,8
829,5304149,1,5,9,38,5345624,62,100,4.05,49,0.49,1,13.78527778,253.46200000000002,109.3673469,38,79.03225806451613,13
830,5302142,3,5,20,54,3885460,43,69,3.4,22,0.31884058,1,6.130555556,111.208,115.04545449999999,26,51.162790697674424,21
831,5297335,7,5,19,52,5436622,50,73,4.428571429,26,0.356164384,1,7.368055556,119.20200000000001,105.38461540000002,23,52.0,24
832,5296824,3,5,13,17,4946045,30,97,3.666666667,20,0.206185567,1,5.967222222,96.277,102.7,67,66.66666666666666,10
833,5295836,4,5,9,24,5377873,22,126,4.5,17,0.134920635,1,3.971666667,70.556,96.70588235,104,77.27272727272727,5
834,5294547,2,5,13,52,5383896,26,64,4.375,17,0.265625,1,5.321666667,77.804,102.4117647,38,65.38461538461539,9
835,5288834,5,5,12,39,4824602,32,112,5.0,12,0.107142857,1,2.336666667,48.726000000000006,94.75,80,37.5,20
836,5288367,4,5,17,24,4942138,32,86,3.9375,24,0.27906976699999997,1,7.469722222000001,135.912,118.75,54,75.0,8
837,5287268,5,5,8,22,5386830,35,50,4.461538462,28,0.56,1,5.22,87.559,81.0,15,80.0,7
838,5286475,4,5,8,54,4264706,27,77,4.25,6,0.07792207799999999,1,1.333611111,21.971,85.16666667,50,22.22222222222222,21
839,5286057,1,5,7,37,3784000,65,127,4.304347826,49,0.38582677200000004,1,13.12166667,207.273,95.53061224,62,75.38461538461539,16
840,5285685,5,5,20,12,4785529,56,98,4.3125,29,0.295918367,1,7.609444444,136.342,113.68965520000002,42,51.78571428571429,27
841,5276036,7,5,21,12,3665614,25,136,3.8,18,0.132352941,1,5.255555556,111.495,125.6111111,111,72.0,7
842,5274185,3,5,21,15,4763128,19,48,4.8888888889999995,15,0.3125,1,3.9897222219999997,90.029,126.46666670000002,29,78.94736842105263,4
843,5273096,1,5,18,23,4358566,67,166,4.375,35,0.210843373,1,8.765277778,151.629,95.57142857,99,52.23880597014925,32
844,5272682,3,5,19,28,4586907,61,142,4.291666667,50,0.352112676,1,13.94972222,267.96,113.38,81,81.9672131147541,11
845,5271687,1,5,5,48,4194635,59,133,4.277777778,49,0.36842105299999994,1,13.82972222,221.84,99.89795918,74,83.05084745762711,10
846,5271509,2,5,19,10,4213953,11,58,4.5,4,0.068965517,1,1.614722222,23.055999999999997,118.0,47,36.36363636363637,7
847,5270676,7,5,17,59,4518580,59,79,4.0,45,0.569620253,1,11.99138889,219.56599999999997,104.9777778,20,76.27118644067797,14
848,5270410,3,5,19,24,4640924,14,99,4.0,6,0.060606060999999996,1,2.039444444,41.516999999999996,137.0,85,42.857142857142854,8
849,5266272,2,5,10,52,3442296,49,69,4.3684210530000005,36,0.52173913,1,9.748888889,152.235,95.36111111,20,73.46938775510205,13
850,5265495,2,5,5,48,3520281,52,116,4.1875,26,0.224137931,1,7.024444443999999,152.072,127.07692309999999,64,50.0,26
851,5265447,3,5,8,0,4871622,32,70,3.5,15,0.214285714,1,3.5736111110000004,56.138999999999996,90.73333333,38,46.875,17
852,5265138,2,5,20,0,5390387,90,296,4.322580645,69,0.233108108,1,17.82555556,318.04,101.884058,206,76.66666666666667,21
853,5264597,3,5,13,22,5041651,92,147,4.333333333,39,0.265306122,1,1.770277778,93.539,73.84615385,55,42.391304347826086,53
854,5262474,5,5,9,15,3704722,93,156,4.1,57,0.365384615,1,18.88527778,290.52,110.17543859999999,63,61.29032258064516,36
855,5258211,1,5,10,45,4898273,52,208,4.0,6,0.028846154,1,1.3897222219999998,30.18,105.33333329999999,156,11.538461538461538,46
856,5257598,1,5,14,45,5262650,87,124,4.5,44,0.35483871,1,8.921666667,149.16,82.54545455,37,50.57471264367817,43
857,5256793,5,5,11,27,3253320,39,98,4.428571429,17,0.173469388,1,3.8216666669999997,80.446,106.76470590000001,59,43.58974358974359,22
858,5256637,2,5,11,47,4983733,59,82,3.625,31,0.37804878,1,3.9472222219999997,72.514,74.19354839,23,52.54237288135594,28
859,5255932,5,5,17,39,3643276,57,224,4.052631579,39,0.17410714300000002,1,12.48055556,196.692,113.38461540000002,167,68.42105263157895,18
860,5255321,2,5,8,46,4673935,32,71,4.666666667,25,0.352112676,1,6.629166667000001,125.37799999999999,108.04,39,78.125,7
861,5254374,4,5,20,23,3481302,40,133,3.777777778,20,0.15037594,1,0.13972222199999998,39.097,68.5,93,50.0,20
862,5250472,2,5,13,20,3898959,83,256,4.484848485,55,0.21484375,1,15.72833333,224.93200000000002,94.45454545,173,66.26506024096386,28
863,5250341,3,5,19,2,3664727,124,141,4.173913043,99,0.70212766,1,25.15638889,427.157,97.15151515,17,79.83870967741935,25
864,5250079,1,5,14,55,5140784,42,173,4.333333333,33,0.190751445,1,7.170555556,127.09700000000001,88.15151515,131,78.57142857142857,9
865,5249631,2,5,18,58,5348785,27,180,4.0,16,0.088888889,1,6.5194444439999995,118.494,144.125,153,59.25925925925925,11
866,5249447,5,5,12,32,5079369,29,53,4.3636363639999995,25,0.471698113,1,8.386111111,153.55,125.24,24,86.20689655172413,4
867,5248346,5,5,14,40,3973870,23,149,4.8888888889999995,16,0.10738255,1,5.8663888889999996,98.645,125.6875,126,69.56521739130434,7
868,5237534,2,5,10,21,4648647,27,82,4.5,4,0.048780488,0,0.009166667,0.539,45.0,55,14.814814814814813,23
869,5231863,7,5,10,51,4040786,23,38,4.666666667,14,0.36842105299999994,1,4.093611111,71.842,108.7142857,15,60.86956521739131,9
870,5228379,4,5,0,2,4848542,72,110,3.652173913,58,0.527272727,1,15.70972222,287.072,118.12068970000001,38,80.55555555555556,14
871,5227760,3,5,0,33,3977023,19,53,3.666666667,9,0.16981132100000002,1,1.3419444440000001,31.948,123.55555559999999,34,47.368421052631575,10
872,5226849,2,5,14,28,5216011,25,56,4.571428571,18,0.321428571,1,2.5875,27.004,59.11111111,31,72.0,7
873,5224799,4,5,16,59,4899866,29,61,4.785714286,25,0.409836066,1,9.205,124.272,106.48,32,86.20689655172413,4
874,5224535,1,5,11,10,4722839,16,22,4.5,8,0.363636364,1,2.621388889,43.568999999999996,111.75,6,50.0,8
875,5219854,4,5,9,49,5416074,49,80,4.625,33,0.4125,1,9.191388889,163.28,108.1515152,31,67.3469387755102,16
876,5219846,5,5,16,46,4633603,61,121,4.25,50,0.41322314,1,11.80638889,207.79,93.78,60,81.9672131147541,11
877,5213677,2,5,7,56,4726930,19,44,4.428571429,15,0.340909091,1,2.893888889,67.518,100.2,25,78.94736842105263,4
878,5213341,4,5,23,16,5389679,21,124,4.0,2,0.016129031999999998,1,0.46388888899999997,13.695,158.0,103,9.523809523809524,19
879,5212626,6,5,10,8,4002609,34,70,3.928571429,30,0.428571429,1,7.715,155.043,112.4,36,88.23529411764706,4
880,5210868,3,5,19,12,4867747,71,87,4.458333333,62,0.712643678,1,20.46583333,319.77,109.7096774,16,87.32394366197182,9
881,5203454,5,5,22,44,3215766,18,61,4.75,15,0.24590163899999998,1,3.8061111110000003,73.89399999999999,107.53333329999998,43,83.33333333333334,3
882,5203223,5,5,13,18,5372654,41,60,4.176470588,33,0.55,1,8.415,134.42600000000002,92.51515152,19,80.48780487804879,8
883,5202469,5,5,14,55,3965362,74,135,4.181818182,33,0.24444444399999998,1,9.119166667,174.782,113.969697,61,44.5945945945946,41
884,5201418,2,5,14,39,3761731,26,38,4.272727273,20,0.526315789,1,5.393055556,87.29299999999999,99.45,12,76.92307692307693,6
885,5198241,4,5,17,12,5031216,41,179,3.4375,32,0.17877095,1,7.333333333,121.94,93.21875,138,78.04878048780488,9
886,5198213,4,5,15,23,5241011,63,125,4.5,45,0.36,1,6.444444444,107.73200000000001,71.06666667,62,71.42857142857143,18
887,5197330,3,5,17,6,5413064,86,207,3.6086956519999998,48,0.231884058,1,16.57138889,267.596,118.85416670000001,121,55.81395348837209,38
888,5197328,5,5,8,35,3819260,14,25,4.666666667,11,0.44,1,2.995277778,61.292,117.54545449999999,11,78.57142857142857,3
889,5196875,4,5,10,36,3511352,39,74,4.153846154,33,0.44594594600000004,1,7.868055556,141.96200000000002,102.30303029999999,35,84.61538461538461,6
890,5196461,1,5,19,57,5006004,13,95,5.0,6,0.063157895,1,1.6297222219999998,30.772,108.83333329999999,82,46.15384615384615,7
891,5195083,3,5,19,11,4624810,37,100,5.0,4,0.04,1,2.7125,19.408,104.25,63,10.81081081081081,33
892,5187545,2,5,19,9,4792765,66,105,4.461538462,20,0.19047619,1,0.687222222,15.552,51.8,39,30.303030303030305,46
893,5175155,2,5,9,4,5286526,21,54,4.0,2,0.037037037,1,0.180277778,2.252,49.5,33,9.523809523809524,19
894,5174633,1,5,12,31,5300387,39,59,4.1,23,0.38983050799999996,1,6.436666667000001,113.319,108.69565220000001,20,58.97435897435898,16
895,5173941,3,5,21,38,5186874,29,61,4.384615385,25,0.409836066,1,7.857222222000001,135.759,118.76,32,86.20689655172413,4
896,5173784,5,5,13,34,5197480,21,70,4.5,13,0.185714286,1,4.020555556000001,56.299,97.30769231,49,61.904761904761905,8
897,5170666,2,5,19,11,4928659,36,138,4.875,23,0.166666667,1,6.430277778,121.28399999999999,115.9565217,102,63.888888888888886,13
898,5168997,5,5,9,42,4714957,43,102,4.777777778,31,0.303921569,1,2.268888889,66.255,68.58064516,59,72.09302325581395,12
899,5165907,6,5,17,13,5206368,18,275,4.333333333,5,0.018181818,1,1.686111111,25.095,111.8,257,27.77777777777778,13
900,5164474,5,5,11,41,4906638,39,142,5.0,6,0.042253520999999995,1,1.1080555559999998,21.274,87.33333333,103,15.384615384615385,33
901,5164027,2,5,8,1,3063951,8,46,4.6,7,0.152173913,1,1.871111111,51.347,140.5714286,38,87.5,1
902,5163916,2,5,14,20,4811519,40,136,4.153846154,25,0.18382352899999999,1,6.939166667,148.33100000000002,122.32,96,62.5,15
903,5159194,2,5,12,39,5148164,54,73,4.5,35,0.479452055,1,8.946666667,139.52700000000002,90.85714286,19,64.81481481481481,19
904,5158721,5,5,10,26,5110813,21,30,4.0,20,0.666666667,1,6.221111111,90.779,105.0,9,95.23809523809523,1
905,5158512,3,5,15,35,5252141,10,24,5.0,4,0.166666667,1,1.7322222219999999,30.717,144.75,14,40.0,6
906,5141749,5,5,10,50,4398747,25,39,4.5,4,0.102564103,1,0.932222222,13.413,84.0,14,16.0,21
907,5140279,2,5,2,45,5049876,54,101,4.0,23,0.227722772,1,5.101666667,89.583,121.65217390000001,47,42.592592592592595,31
908,5131960,5,5,15,49,5158418,23,54,4.571428571,17,0.314814815,1,3.9655555560000004,69.476,92.76470588,31,73.91304347826086,6
909,5131946,2,5,9,47,4585051,74,82,4.0,57,0.695121951,1,12.67666667,245.583,110.8070175,8,77.02702702702703,17
910,5130595,2,5,12,40,3056015,34,53,4.538461538,23,0.433962264,1,6.0225,92.45700000000001,93.60869565,19,67.64705882352942,11
911,5128598,3,5,11,16,5147063,37,60,4.4,31,0.5166666670000001,1,5.8475,114.29299999999999,90.87096774,23,83.78378378378379,6
912,5124283,1,5,18,41,3061524,70,97,4.48,51,0.525773196,1,15.26666667,239.291,102.13725490000002,27,72.85714285714285,19
913,5123131,3,5,6,28,4795141,25,52,5.0,9,0.173076923,1,2.665833333,47.87,109.44444440000001,27,36.0,16
914,5123003,3,5,18,36,4088833,35,125,4.428571429,24,0.192,1,7.625555556,128.92600000000002,114.70833329999999,90,68.57142857142857,11
915,5122168,3,5,9,23,5294705,42,163,4.333333333,22,0.134969325,1,5.011388889,91.435,94.45454545,121,52.38095238095239,20
916,5120882,3,5,12,19,5195246,44,84,3.4,19,0.226190476,1,6.6163888889999996,96.874,111.8947368,40,43.18181818181818,25
917,5115571,6,5,21,0,5076300,24,41,3.8181818180000002,21,0.5121951220000001,1,2.9225,93.147,102.09523809999999,17,87.5,3
918,5115463,3,5,16,27,5157207,24,178,4.5,18,0.101123596,1,6.269166667,101.039,116.33333329999999,154,75.0,6
919,5114627,4,5,14,31,4711315,84,182,4.0,67,0.368131868,1,19.895,372.509,116.89552240000002,98,79.76190476190477,17
920,5113871,2,5,11,33,5011721,51,118,4.6875,30,0.254237288,1,8.698333332999999,164.96200000000002,116.56666670000001,67,58.82352941176471,21
921,5113855,4,5,16,41,5041641,60,260,3.666666667,12,0.046153846,1,3.085555556,52.272,95.75,200,20.0,48
922,5107320,7,5,20,0,4636753,47,53,4.3,45,0.849056604,1,12.95333333,216.516,103.6,6,95.74468085106383,2
923,5106546,1,5,22,37,5377676,86,105,3.964285714,64,0.60952381,1,17.46833333,310.17900000000003,124.203125,19,74.4186046511628,22
924,5106365,7,5,21,10,5083054,25,39,3.888888889,19,0.487179487,1,3.123888889,60.23,79.94736842,14,76.0,6
925,5105736,2,5,19,35,4640232,14,82,4.0,3,0.036585366,1,0.779166667,14.972000000000001,107.33333329999999,68,21.428571428571427,11
926,5102685,1,5,7,47,3750224,76,109,4.4,60,0.5504587160000001,1,16.2275,289.654,107.83333329999999,33,78.94736842105263,16
927,5090027,3,5,15,36,4450035,31,84,4.8571428569999995,25,0.297619048,1,7.688055556,123.945,108.08,53,80.64516129032258,6
928,5069691,2,5,15,10,3751786,41,131,4.125,28,0.213740458,1,6.330833332999999,108.882,92.85714286,90,68.29268292682927,13
929,5069166,1,5,13,57,5241197,32,79,4.2,11,0.13924050599999999,1,3.1988888889999996,53.033,105.54545449999999,47,34.375,21
930,5054538,7,5,17,13,4459313,26,93,4.444444444,19,0.204301075,1,6.129444444,112.15299999999999,121.0,67,73.07692307692307,7
931,5053890,1,5,14,34,5243910,63,79,4.3684210530000005,39,0.49367088600000003,1,8.356111111,131.113,82.02564103,16,61.904761904761905,24
932,5051893,2,5,6,36,4468817,36,112,4.285714286,32,0.28571428600000004,1,8.861666667,158.967,107.40625,76,88.88888888888889,4
933,5051512,1,5,17,28,5365922,11,136,4.75,7,0.051470588,1,1.771111111,40.783,135.0,125,63.63636363636363,4
934,5051117,3,5,9,42,4040944,70,195,4.117647058999999,35,0.179487179,1,9.638055556,131.423,88.2,125,50.0,35
935,5043591,2,5,11,15,4455322,64,169,4.333333333,41,0.24260355,1,6.95,153.33,91.56097561,105,64.0625,23
936,5035445,1,5,18,33,3369065,39,98,4.461538462,28,0.28571428600000004,1,6.94,117.331,96.10714286,59,71.7948717948718,11
937,5033434,3,5,10,27,3624213,72,158,4.4,47,0.297468354,1,14.09166667,217.332,102.0,86,65.27777777777779,25
938,5027247,7,5,20,0,3469339,33,107,4.818181818,28,0.261682243,1,6.322777778,147.042,115.92857140000001,74,84.84848484848484,5
939,5025815,4,5,10,58,3560771,39,83,4.4,11,0.13253012,1,2.4252777780000003,34.334,76.90909091,44,28.205128205128204,28
940,5025622,4,5,14,2,5264966,81,133,4.416666667,42,0.31578947399999996,1,14.5775,234.437,117.0952381,52,51.85185185185185,39
941,5024883,4,5,22,30,4123031,41,95,4.466666667,36,0.37894736799999995,1,6.260277778,140.762,94.61111111,54,87.8048780487805,5
942,5019237,5,5,18,5,4865859,66,130,4.583333333,44,0.33846153799999995,1,8.500833333,154.125,86.06818182,64,66.66666666666666,22
943,5019119,5,5,10,55,3478642,63,90,4.4,45,0.5,1,14.14666667,243.475,117.6,27,71.42857142857143,18
944,5017506,5,5,13,27,5362040,83,157,4.032258065,63,0.401273885,1,17.67472222,314.194,107.0952381,74,75.90361445783132,20
945,5017051,3,5,17,16,4058013,80,124,4.628571429,57,0.459677419,1,12.5525,230.128,94.84210526,44,71.25,23
946,5011765,5,5,11,24,5390788,19,41,3.714285714,15,0.365853659,1,4.085555556,68.601,103.0666667,22,78.94736842105263,4
947,5010471,7,5,18,19,5317965,92,122,4.289473684,73,0.598360656,1,21.78305556,356.61300000000006,107.0273973,30,79.34782608695652,19
948,5007005,2,5,10,1,5178055,14,21,4.25,5,0.23809523800000001,1,1.691944444,24.701999999999998,107.0,7,35.714285714285715,9
949,5005684,5,5,13,29,4716746,80,242,4.375,51,0.21074380199999998,1,12.9125,238.745,102.3137255,162,63.74999999999999,29
950,5004253,1,5,19,15,4752919,49,90,4.545454545,37,0.41111111100000003,1,10.93083333,189.49599999999998,108.24324320000001,41,75.51020408163265,12
951,5004248,6,5,6,12,4033146,37,87,4.571428571,29,0.333333333,1,7.102777777999999,109.70299999999999,90.37931034,50,78.37837837837837,8
952,5004246,2,5,8,42,4792765,40,125,3.666666667,8,0.064,1,2.156944444,39.404,104.375,85,20.0,32
953,5003854,7,5,12,3,4588257,51,175,4.1052631580000005,46,0.262857143,1,13.1,208.457,102.0,124,90.19607843137256,5
954,4995477,5,5,15,3,5414291,16,97,4.8,8,0.082474227,1,3.917777778,62.747,148.875,81,50.0,8
955,4986081,3,5,17,45,5170737,9,188,4.307563701,2,0.010638298000000001,1,0.882222222,13.86,141.0,179,22.22222222222222,7
956,4980353,2,5,13,15,3706292,19,146,4.5,8,0.054794521,1,0.907222222,17.97,70.5,127,42.10526315789473,11
957,4978406,5,5,16,49,5427430,48,53,4.523809524,42,0.79245283,1,13.08111111,220.864,109.1428571,5,87.5,6
958,4978171,3,5,18,32,5281264,35,103,4.333333333,29,0.281553398,1,5.670277777999999,104.587,87.34482759,68,82.85714285714286,6
959,4973346,5,5,20,12,4255951,9,56,4.5,7,0.125,1,1.8272222219999998,30.684,100.0,47,77.77777777777779,2
960,4970750,2,5,15,4,3900846,95,149,4.0882352939999995,69,0.46308724799999995,1,19.73777778,310.149,99.13043478,54,72.63157894736842,26
961,4964684,1,5,14,20,4976190,56,171,4.555555556,35,0.204678363,1,12.76388889,209.71900000000002,120.4571429,115,62.5,21
962,4959958,4,5,8,54,5037196,28,151,4.8,18,0.119205298,1,4.9861111110000005,82.243,101.0555556,123,64.28571428571429,10
963,4959785,7,5,20,9,3081229,37,79,4.444444444,24,0.303797468,1,4.109444444,108.656,107.45833329999999,42,64.86486486486487,13
964,4959687,1,5,21,23,4444541,87,122,4.25,72,0.590163934,1,16.91944444,330.491,103.54166670000001,35,82.75862068965517,15
965,4957928,1,5,19,17,5398895,11,54,4.0,3,0.055555556,1,0.745,11.115,88.66666667,43,27.27272727272727,8
966,4942175,1,5,11,41,4150355,42,59,4.882352941000001,36,0.610169492,1,9.559166667000001,156.695,100.0,17,85.71428571428571,6
967,4940895,1,5,9,54,5152505,15,29,4.5,7,0.24137931,1,3.1380555560000003,37.408,123.42857140000001,14,46.666666666666664,8
968,4921112,4,5,17,36,4146846,85,171,4.34375,57,0.333333333,1,18.05611111,305.855,113.4912281,86,67.05882352941175,28
969,4915129,5,5,10,32,5050873,73,101,4.36,60,0.5940594060000001,1,22.47527778,336.306,115.21666670000002,28,82.1917808219178,13
970,4915123,7,5,15,27,4221980,44,103,4.1875,26,0.25242718399999997,1,7.3602777779999995,135.741,111.7307692,59,59.09090909090909,18
971,4912442,3,5,11,34,3741424,26,86,4.75,11,0.127906977,1,3.18,45.141000000000005,94.27272727,60,42.30769230769231,15
972,4893233,2,5,7,51,3191381,46,85,4.1578947369999995,38,0.44705882399999997,1,5.748333333,101.146,74.02631579,39,82.6086956521739,8
973,4886466,2,5,19,28,3511352,42,213,4.538461538,28,0.131455399,1,6.615,153.977,119.8928571,171,66.66666666666666,14
974,4885518,2,5,17,19,3496628,39,106,4.666666667,12,0.11320754699999999,1,0.281666667,12.279000000000002,54.75,67,30.76923076923077,27
975,4882143,4,5,17,15,4788059,40,55,4.375,31,0.563636364,1,8.893888889,141.977,101.3548387,15,77.5,9
976,4879692,2,5,8,13,5225127,58,125,4.153846154,47,0.376,1,16.01416667,287.186,124.6170213,67,81.03448275862068,11
977,4878864,4,5,16,16,5146130,35,95,4.923076923,25,0.263157895,1,7.956388888999999,125.179,105.12,60,71.42857142857143,10
978,4873380,5,5,22,8,5047790,28,50,4.0,16,0.32,1,1.1258333329999999,45.273,90.0625,22,57.14285714285714,12
979,4873318,1,5,11,40,3584895,60,82,4.1071428569999995,46,0.56097561,1,13.22694444,229.623,108.5434783,22,76.66666666666667,14
980,4869738,1,5,22,7,4168256,33,102,4.6363636360000005,23,0.225490196,1,5.145,114.883,110.30434779999999,69,69.6969696969697,10
981,4867741,5,5,19,44,5244405,26,62,4.8571428569999995,12,0.193548387,1,3.389166667,59.276,105.08333329999999,36,46.15384615384615,14
982,4854712,5,5,17,21,4846602,44,188,4.1875,30,0.159574468,1,5.984444444,91.09700000000001,80.96666667,144,68.18181818181817,14
983,4844951,5,5,15,36,3999427,24,49,4.181818182,20,0.408163265,1,6.305,98.04799999999999,105.45,25,83.33333333333334,4
984,4830034,2,5,16,9,4773337,31,104,4.1,18,0.173076923,1,7.261111111,104.729,120.1111111,73,58.06451612903226,13
985,4827426,2,5,18,38,4971511,52,167,4.615384615,22,0.131736527,1,6.061111111000001,89.781,92.36363636,115,42.30769230769231,30
986,4826866,7,5,12,16,5016381,20,51,4.125,12,0.235294118,1,4.988888889,96.334,169.66666669999998,31,60.0,8
987,4825787,3,5,10,2,5350504,44,94,3.777777778,22,0.23404255300000001,1,3.816111111,61.352,76.36363636,50,50.0,22
988,4825053,4,5,20,9,5128451,33,36,4.5,30,0.833333333,1,6.7694444439999995,146.08,112.43333329999999,3,90.9090909090909,3
989,4810047,5,5,19,34,5040359,24,51,4.307563701,2,0.039215686,1,0.696666667,13.700999999999999,138.5,27,8.333333333333332,22
990,4809284,4,5,8,19,5066277,25,45,4.666666667,7,0.15555555599999998,1,2.312222222,52.205,147.0,20,28.000000000000004,18
991,4803994,2,5,12,15,5182294,34,72,4.545454545,23,0.319444444,1,6.725277778,132.253,122.43478259999999,38,67.64705882352942,11
992,4798200,3,5,8,47,3090772,29,53,3.833333333,22,0.41509434,1,6.333611111000001,98.90700000000001,102.40909090000001,24,75.86206896551724,7
993,4795376,5,5,16,5,4771537,23,117,5.0,4,0.034188034,1,1.346388889,11.115,90.0,94,17.391304347826086,19
994,4790475,3,5,8,13,4111832,65,164,3.9090909089999997,20,0.12195122,1,5.444444444,97.07,103.85,99,30.76923076923077,45
995,4790017,1,5,18,48,4239211,34,103,4.9,23,0.22330097100000001,1,4.610833333,93.68299999999999,92.0,69,67.64705882352942,11
996,4773296,7,5,19,3,5442620,27,155,4.666666667,19,0.122580645,1,5.581388888999999,119.26,129.36842109999998,128,70.37037037037037,8
997,4759510,5,5,18,9,4944977,5,117,5.0,4,0.034188034,1,1.444166667,22.75,119.5,112,80.0,1
998,4749557,2,5,16,54,3538592,26,70,3.8,18,0.257142857,1,6.448888889,117.579,126.66666670000001,44,69.23076923076923,8
999,4747142,2,5,22,12,4899778,28,30,4.6363636360000005,20,0.666666667,1,3.748888889,78.336,95.95,2,71.42857142857143,8
1000,4741654,4,5,17,52,4479999,17,218,4.5,7,0.032110092,1,2.065277778,32.038000000000004,97.28571429,201,41.17647058823529,10
1001,4740161,1,5,19,59,4624744,18,162,5.0,7,0.043209877,1,1.7647222219999998,27.463,94.57142857,144,38.88888888888889,11
1002,4740151,7,5,22,53,5300106,28,46,4.4,17,0.36956521700000006,1,3.267222222,70.642,103.70588240000001,18,60.71428571428571,11
1003,4735617,1,5,16,33,3230022,63,131,4.535714286,50,0.381679389,1,15.28111111,270.435,115.76,68,79.36507936507937,13
1004,4724552,4,5,11,39,4464894,68,107,4.2758620689999995,56,0.523364486,1,13.25305556,216.077,89.67857143,39,82.35294117647058,12
1005,4723107,5,5,16,23,3301304,52,60,3.9,28,0.46666666700000003,1,5.541666667,89.24600000000001,82.64285714,8,53.84615384615385,24
1006,4720242,4,5,9,17,5318134,31,79,4.571428571,15,0.18987341800000002,1,2.341388889,48.012,85.06666667,48,48.38709677419355,16
1007,4719007,5,5,11,51,4467185,36,53,4.666666667,27,0.509433962,1,6.3272222220000005,105.87,90.81481481,17,75.0,9
1008,4718173,4,5,20,42,5126851,17,75,3.2,10,0.133333333,1,3.3194444439999997,62.604,132.2,58,58.82352941176471,7
1009,4716125,4,5,18,19,4449223,22,97,3.25,13,0.134020619,1,3.270833333,44.99,85.0,75,59.09090909090909,9
1010,4713179,1,5,20,9,4133106,21,82,4.0,7,0.085365854,1,0.005277778,6.489,54.71428571,61,33.33333333333333,14
1011,4713124,3,5,9,34,3195697,25,60,4.0,16,0.26666666699999997,1,3.586944444,53.736999999999995,84.0625,35,64.0,9
1012,4712145,2,5,16,46,4638403,38,116,4.571428571,26,0.224137931,1,9.168888889,181.37,135.15384619999998,78,68.42105263157895,12
1013,4705527,5,5,16,7,4058217,61,103,4.05,43,0.417475728,1,9.757777778,154.388,87.27906977,42,70.49180327868852,18
1014,4703843,5,5,11,45,4982261,24,87,4.1111111110000005,18,0.20689655199999998,1,5.2425,92.08200000000001,110.16666670000001,63,75.0,6
1015,4691947,5,5,20,57,3747524,14,90,4.75,7,0.07777777799999999,1,1.399444444,24.51,84.85714286,76,50.0,7
1016,4680724,3,5,13,43,5327640,22,36,3.875,16,0.444444444,1,5.276944444,76.782,104.125,14,72.72727272727273,6
1017,4679323,3,5,12,35,5186037,16,121,4.8,8,0.066115702,1,3.686111111,60.133,143.0,105,50.0,8
1018,4678838,5,5,13,5,5425731,80,107,4.6363636360000005,63,0.588785047,1,20.64861111,323.54900000000004,110.7619048,27,78.75,17
1019,4673799,5,5,14,4,3949686,98,325,4.057142857,57,0.175384615,1,17.36166667,255.52900000000002,99.17543859999999,227,58.16326530612245,41
1020,4672609,7,5,8,47,5435066,24,268,4.125,15,0.055970149000000004,1,3.1338888889999996,55.88399999999999,88.33333333,244,62.5,9
1021,4672272,2,5,12,39,4011865,12,94,3.75,8,0.08510638300000001,1,3.1341666669999997,50.361999999999995,129.5,82,66.66666666666666,4
1022,4652099,1,5,18,58,4824301,33,51,3.714285714,24,0.470588235,1,6.7638888889999995,126.088,112.04166670000001,18,72.72727272727273,9
1023,4651915,5,5,19,24,5059814,26,108,3.9090909089999997,20,0.185185185,1,6.188888888999999,111.745,121.15,82,76.92307692307693,6
1024,4647808,6,5,19,34,5096191,51,260,4.6,27,0.10384615400000001,1,6.5655555560000005,91.21,94.40740741,209,52.94117647058824,24
1025,4644848,4,5,21,59,5191665,35,40,3.9090909089999997,26,0.65,1,7.483611111,165.61700000000002,127.6923077,5,74.28571428571429,9
1026,4639206,2,5,17,10,4928121,26,175,4.666666667,8,0.04571428599999999,1,3.1,53.108999999999995,133.375,149,30.76923076923077,18
1027,4627142,2,5,13,18,3534796,19,52,4.285714286,11,0.21153846199999998,1,2.995833333,51.692,101.2727273,33,57.89473684210527,8
1028,4624228,1,5,17,49,3534435,18,185,3.666666667,7,0.037837838,1,3.0044444439999998,54.08,146.8571429,167,38.88888888888889,11
1029,4613526,2,5,11,35,4944639,61,195,4.3125,31,0.158974359,1,9.307222222,166.725,113.22580649999999,134,50.81967213114754,30
1030,4612373,1,5,7,47,4155810,20,45,3.142857143,15,0.333333333,1,3.189166667,70.363,103.5333333,25,75.0,5
1031,4611227,3,5,11,45,5184662,57,105,4.461538462,27,0.257142857,1,8.768888889,144.41,111.03703700000001,48,47.368421052631575,30
1032,4606374,3,5,20,17,4531954,52,143,3.857142857,42,0.293706294,1,10.49055556,208.55,107.42857140000001,91,80.76923076923077,10
1033,4592639,4,5,11,57,4045945,45,128,3.666666667,37,0.2890625,1,10.55583333,181.078,104.4324324,83,82.22222222222221,8
1034,4579497,2,5,13,47,5207833,34,121,3.75,13,0.107438017,1,2.8422222219999997,51.693000000000005,94.38461538,87,38.23529411764706,21
1035,4564875,7,5,21,16,4525682,22,123,4.777777778,15,0.12195122,1,3.6175,66.178,99.86666667,101,68.18181818181817,7
1036,4557650,2,5,17,37,4330298,40,53,4.230769231,23,0.433962264,1,5.264166667,93.294,93.65217391,13,57.49999999999999,17
1037,4555145,5,5,9,39,5230419,60,175,4.210526316,32,0.182857143,1,9.183888889,176.415,114.75,115,53.333333333333336,28
1038,4552096,5,5,17,28,5424650,64,182,4.615384615,35,0.192307692,1,8.529166667,135.894,90.45714286,118,54.6875,29
1039,4540166,5,5,16,36,4129314,50,123,4.296296296,41,0.333333333,1,11.79611111,199.372,106.0,73,82.0,9
1040,4538988,6,5,16,0,5157454,34,133,3.9375,20,0.15037594,1,5.343333333,82.979,98.75,99,58.82352941176471,14
1041,4529926,5,5,8,55,5312730,18,52,4.166666667,10,0.192307692,1,2.580277778,43.928999999999995,133.8,34,55.55555555555556,8
1042,4517057,1,5,14,1,5125284,74,167,4.3,45,0.269461078,1,13.75444444,223.646,106.24444440000002,93,60.810810810810814,29
1043,4516926,7,5,7,52,4525495,73,222,4.166666667,19,0.08558558599999999,1,4.486666667,97.65100000000001,111.63157890000001,149,26.027397260273972,54
1044,4510026,5,5,13,44,4902442,26,58,4.5,6,0.10344827599999999,1,1.187777778,19.836,83.5,32,23.076923076923077,20
1045,4498157,5,5,18,50,4715775,52,67,4.523809524,44,0.656716418,1,8.394444444,156.257,88.22727273,15,84.61538461538461,8
1046,4493566,7,5,17,44,5344657,18,52,4.333333333,6,0.115384615,1,1.8975,21.045,87.66666667,34,33.33333333333333,12
1047,4492521,5,5,10,54,3108446,22,107,5.0,2,0.018691588999999998,1,0.431666667,7.952000000000001,89.5,85,9.090909090909092,20
1048,4492069,3,5,12,10,4013647,44,93,4.6,28,0.301075269,1,6.483333332999999,134.968,103.9642857,49,63.63636363636363,16
1049,4486278,1,5,13,10,3879557,46,60,4.458333333,35,0.583333333,1,8.45,137.269,89.31428571,14,76.08695652173914,11
1050,4480466,1,5,20,29,3627798,13,43,4.666666667,5,0.11627907,1,0.7725,21.024,95.8,30,38.46153846153847,8
1051,4472618,4,5,13,54,4879441,48,288,3.0,2,0.006944444,1,0.000833333,4.2,69.0,240,4.166666666666666,46
1052,4465421,3,5,17,0,5017268,45,57,4.666666667,33,0.578947368,1,11.43222222,180.655,114.39393940000001,12,73.33333333333333,12
1053,4464438,5,5,16,3,4554518,17,54,4.166666667,13,0.240740741,1,2.93,51.949,99.46153846,37,76.47058823529412,4
1054,4441781,2,5,17,16,5273772,38,49,3.777777778,32,0.653061224,1,7.255833332999999,127.682,96.5,11,84.21052631578947,6
1055,4428818,3,5,14,0,4892299,25,114,4.833333333,13,0.114035088,1,2.916944444,56.053000000000004,97.46153846,89,52.0,12
1056,4423322,7,5,10,31,5429797,7,16,3.0,6,0.375,1,1.585833333,24.896,97.16666667,9,85.71428571428571,1
1057,4409917,1,5,17,49,4574612,13,97,4.666666667,6,0.06185567,1,2.119166667,30.997,108.16666670000001,84,46.15384615384615,7
1058,4409159,5,5,9,24,4746350,81,161,4.434782609,51,0.316770186,1,16.11194444,242.86,104.17647059999999,80,62.96296296296296,30
1059,4408253,4,5,16,51,4322427,23,30,4.285714286,20,0.666666667,1,4.7725,95.59899999999999,101.25,7,86.95652173913044,3
1060,4397579,1,5,8,26,4144645,18,54,4.0,6,0.111111111,1,1.731944444,35.982,120.16666670000001,36,33.33333333333333,12
1061,4376421,1,5,12,32,3776070,137,203,4.37037037,102,0.502463054,1,26.19805556,468.843,102.5,66,74.45255474452554,35
1062,4351430,3,5,11,54,4706658,20,41,4.307563701,6,0.146341463,1,0.350555556,5.367999999999999,50.66666667,21,30.0,14
1063,4348063,1,5,21,29,5361502,25,54,5.0,8,0.148148148,1,0.523055556,10.279000000000002,62.25,29,32.0,17
1064,4337628,7,5,20,37,4674518,13,61,4.5,8,0.131147541,1,2.892222222,40.445,109.75,48,61.53846153846154,5
1065,4329565,4,5,9,28,5402199,78,245,4.703703704,47,0.191836735,1,12.66444444,225.93099999999998,106.0851064,167,60.256410256410255,31
1066,4326246,4,5,17,8,5330726,33,104,4.6,24,0.23076923100000002,1,7.330277777999999,125.425,113.95833329999999,71,72.72727272727273,9
1067,4325997,1,5,16,2,5397031,40,87,4.272727273,26,0.298850575,1,6.465,109.221,97.76923077,47,65.0,14
1068,4314261,4,5,17,13,4920156,42,164,4.066666667,27,0.164634146,1,7.301666667,126.147,102.2962963,122,64.28571428571429,15
1069,4303765,3,5,20,55,4909039,25,45,4.7,16,0.355555556,1,3.933888889,69.947,102.3125,20,64.0,9
1070,4303472,4,5,14,59,5273772,17,37,4.666666667,12,0.324324324,1,3.566111111,63.1,112.33333329999999,20,70.58823529411765,5
1071,4291437,7,5,13,21,4206711,46,355,4.571428571,11,0.030985915,1,2.525833333,53.086999999999996,105.2727273,309,23.91304347826087,35
1072,4264488,7,5,21,23,4043504,20,43,3.333333333,16,0.37209302299999997,1,3.1777777780000003,55.187,85.9375,23,80.0,4
1073,4253265,5,5,18,26,4455940,88,166,4.266666667,71,0.42771084299999995,1,17.11722222,318.553,100.0422535,78,80.68181818181817,17
1074,4216761,1,5,16,11,3535516,30,54,3.777777778,16,0.296296296,1,3.127777778,59.61600000000001,87.1875,24,53.333333333333336,14
1075,4212117,2,5,12,8,4725033,47,219,4.272727273,19,0.08675799099999999,1,5.0202777780000005,85.45200000000001,101.1052632,172,40.42553191489361,28
1076,4195371,7,5,8,13,4566067,40,44,3.9411764710000003,33,0.75,1,7.555833333,143.947,97.84848485,4,82.5,7
1077,4195199,1,5,11,10,4548501,50,93,4.583333333,39,0.419354839,1,8.9975,157.365,92.8974359,43,78.0,11
1078,4193386,3,5,19,39,4307849,37,63,4.133333333,26,0.412698413,1,7.0025,112.885,96.34615385,26,70.27027027027027,11
1079,4187580,3,5,17,27,5372735,27,79,4.666666667,26,0.329113924,1,7.546388889,137.486,116.7307692,52,96.29629629629629,1
1080,4186299,1,5,17,58,4331323,22,38,4.8571428569999995,10,0.263157895,1,2.170277778,44.351000000000006,106.7,16,45.45454545454545,12
1081,4157224,2,5,8,53,4575788,32,106,4.454545455,23,0.216981132,1,5.995277777999999,110.58,105.0869565,74,71.875,9
1082,4149121,1,5,11,18,4731422,18,49,3.833333333,11,0.22448979600000002,1,0.0058333330000000004,14.575999999999999,61.45454545,31,61.111111111111114,7
1083,4141462,2,5,9,33,4769500,15,30,4.25,7,0.233333333,1,2.0158333330000002,34.839,103.1428571,15,46.666666666666664,8
1084,4095840,5,5,8,42,4932824,16,24,4.25,14,0.583333333,1,2.681388889,55.198,93.07142857,8,87.5,2
1085,4092419,2,5,10,26,5353060,17,38,4.5,15,0.39473684200000003,1,5.0655555560000005,96.288,131.6,21,88.23529411764706,2
1086,4092353,5,5,13,46,5350482,57,70,4.4375,35,0.5,1,9.000277778,158.359,100.4,13,61.40350877192983,22
1087,4084643,5,5,18,57,4573974,33,45,4.416666667,25,0.5555555560000001,1,7.659166667,138.671,115.6,12,75.75757575757575,8
1088,4038984,3,5,12,26,5108837,13,28,3.2,9,0.321428571,1,3.0488888889999997,46.51,107.2222222,15,69.23076923076923,4
1089,4029834,2,5,17,40,4860112,31,57,4.4,9,0.15789473699999998,1,0.005,16.418,68.22222222,26,29.03225806451613,22
1090,4021044,3,5,19,14,4556249,13,61,5.0,5,0.081967213,1,1.3902777780000002,25.703000000000003,112.6,48,38.46153846153847,8
1091,4011552,2,5,17,17,4820717,36,65,4.0,31,0.47692307700000003,1,7.943888889,142.371,103.09677420000001,29,86.11111111111111,5
1092,4007229,5,5,9,45,5236829,12,64,4.166666667,8,0.125,1,2.579444444,44.291000000000004,118.5,52,66.66666666666666,4
1093,4004192,5,5,11,15,3541003,26,57,4.0,16,0.28070175399999997,1,4.205555556,81.429,109.6875,31,61.53846153846154,10
1094,4003050,3,5,9,17,4916181,14,39,4.5,9,0.23076923100000002,1,2.503055556,56.87,128.11111110000002,25,64.28571428571429,5
1095,3981274,7,5,18,6,5170531,18,30,4.6,8,0.26666666699999997,1,8.355,52.57,131.5,12,44.44444444444444,10
1096,3980730,1,5,8,15,5305967,11,224,4.307563701,2,0.008928571,1,0.433888889,9.713,109.5,213,18.181818181818183,9
1097,3944836,5,5,20,5,4478389,39,55,4.1875,33,0.6,1,8.197222222,144.005,99.96969697,16,84.61538461538461,6
1098,3941874,4,5,16,34,4366558,27,70,5.0,10,0.14285714300000002,1,1.625277778,31.051,81.2,43,37.03703703703704,17
1099,3920495,4,5,19,29,5063587,32,186,3.9,17,0.091397849,1,5.4025,94.932,115.6470588,154,53.125,15
1100,3906430,5,5,18,40,3069501,26,75,4.25,12,0.16,1,4.240833333,83.051,136.91666669999998,49,46.15384615384615,14
1101,3903211,6,5,17,59,5071804,27,41,4.75,22,0.5365853660000001,1,5.595555556,115.124,117.04545449999999,14,81.48148148148148,5
1102,3893740,7,5,14,41,3998370,31,52,3.6363636360000005,24,0.46153846200000004,1,5.840833333,92.2,90.20833333,21,77.41935483870968,7
1103,3886324,5,5,13,44,5239080,55,144,4.0,39,0.270833333,1,11.89166667,180.933,104.974359,89,70.9090909090909,16
1104,3876827,1,5,11,31,4508259,60,127,4.44,46,0.362204724,1,9.245555556000001,139.118,76.93478261,67,76.66666666666667,14
1105,3876324,2,5,18,20,3782389,79,108,4.294117647,40,0.37037037,1,8.921388889,135.983,83.95,29,50.63291139240506,39
1106,3865589,2,5,17,40,3672709,130,289,4.41509434,101,0.349480969,1,28.13638889,509.846,109.47524750000001,159,77.6923076923077,29
1107,3842575,4,5,23,3,5396281,38,74,4.444444444,28,0.37837837799999996,1,7.692777778,142.22899999999998,112.32142859999999,36,73.68421052631578,10
1108,3832175,2,5,18,30,5082639,47,112,4.266666667,31,0.27678571399999996,1,8.735,143.154,103.03225809999999,65,65.95744680851064,16
1109,3823863,4,5,19,14,4874575,19,42,4.214285714,16,0.380952381,1,4.471111111,82.156,114.9375,23,84.21052631578947,3
1110,3821690,1,5,14,16,5220296,43,232,4.8571428569999995,12,0.051724137999999996,1,3.499722222,50.995,96.66666667,189,27.906976744186046,31
1111,3801157,1,5,7,37,5390069,19,44,4.0,13,0.295454545,1,2.596944444,52.354,93.23076923,25,68.42105263157895,6
1112,3771362,2,5,18,7,3829963,42,55,4.333333333,31,0.563636364,1,9.7225,157.27,107.483871,13,73.80952380952381,11
1113,3762149,2,5,12,36,4685202,58,180,4.3888888889999995,33,0.18333333300000001,1,11.14222222,88.988,77.27272727,122,56.896551724137936,25
1114,3754179,5,5,7,38,4826892,43,105,4.5,10,0.095238095,1,2.2766666669999998,44.769,100.8,62,23.25581395348837,33
1115,3736211,6,5,5,57,5373843,44,64,4.3636363639999995,27,0.421875,1,7.549166667000001,123.009,101.2592593,20,61.36363636363637,17
1116,3735534,4,5,16,21,5024330,20,83,4.333333333,15,0.180722892,1,4.156944444,52.037,82.73333333,63,75.0,5
1117,3717125,2,5,6,39,4978650,24,62,4.285714286,13,0.20967741899999998,1,2.666944444,38.577,76.0,38,54.166666666666664,11
1118,3700536,1,5,16,53,5101617,17,41,4.0,14,0.341463415,1,4.568888889,67.646,103.57142859999999,24,82.35294117647058,3
1119,3681964,4,5,10,31,4703209,14,130,4.166666667,12,0.092307692,1,3.5313888889999996,66.23899999999999,116.5,116,85.71428571428571,2
1120,3681569,1,5,15,29,4084269,36,158,4.571428571,26,0.164556962,1,7.1327777779999995,118.868,101.4615385,122,72.22222222222221,10
1121,3637339,4,5,9,56,4371221,62,99,4.48,43,0.434343434,1,9.032222222,210.49200000000002,107.6046512,37,69.35483870967742,19
1122,3633112,5,5,15,34,4981001,20,29,3.857142857,14,0.482758621,1,4.094166667,66.47,108.07142859999999,9,70.0,6
1123,3623101,4,5,10,47,5405012,36,46,4.5,26,0.565217391,1,7.8125,129.274,105.6538462,10,72.22222222222221,10
1124,3620117,5,5,13,22,4034102,13,34,5.0,2,0.058823529000000006,1,0.611111111,9.818,104.0,21,15.384615384615385,11
1125,3613245,7,5,8,20,5222178,27,138,4.6363636360000005,18,0.130434783,1,5.415833332999999,111.10799999999999,124.3888889,111,66.66666666666666,9
1126,3612345,6,5,13,0,3681359,35,102,4.384615385,19,0.18627451,1,7.733888889,125.73200000000001,135.5789474,67,54.285714285714285,16
1127,3609933,2,5,19,23,4811835,11,162,4.4,8,0.04938271599999999,1,1.934166667,39.473,106.375,151,72.72727272727273,3
1128,3593600,4,5,17,31,4273796,54,99,3.85,36,0.363636364,1,7.9513888889999995,146.835,95.25,45,66.66666666666666,18
1129,3589235,2,5,15,22,5360631,20,82,3.8,15,0.18292682899999999,1,4.3263888889999995,85.96700000000001,117.66666670000001,62,75.0,5
1130,3424125,3,5,6,15,5037435,18,55,4.375,13,0.23636363600000002,1,3.057222222,61.477,104.92307690000001,37,72.22222222222221,5
1131,3422168,1,5,10,37,5393916,29,117,4.0,16,0.136752137,1,5.060277778000001,126.816,154.4375,88,55.172413793103445,13
1132,3421197,3,5,8,50,4152809,40,55,3.947368421,30,0.545454545,1,8.312777778,162.447,115.13333329999999,15,75.0,10
1133,3399525,4,5,20,6,4876971,39,101,4.769230769,20,0.198019802,1,3.92,81.84100000000001,102.75,62,51.28205128205128,19
1134,3394918,4,5,11,2,4334655,63,173,4.533333333,27,0.15606936400000002,1,6.65,125.264,103.2222222,110,42.857142857142854,36
1135,3370384,4,5,18,14,4915854,23,43,4.625,15,0.348837209,1,1.126388889,14.869000000000002,52.4,20,65.21739130434783,8
1136,3369332,4,5,13,54,4933178,19,77,5.0,7,0.090909091,1,1.181666667,29.862,95.85714286,58,36.84210526315789,12
1137,3367258,4,5,8,43,4742129,9,56,4.5,5,0.089285714,1,1.303611111,27.118000000000002,118.8,47,55.55555555555556,4
1138,3358941,1,5,12,27,4835435,52,55,4.5,28,0.509090909,1,8.485,134.244,103.6428571,3,53.84615384615385,24
1139,3343921,2,5,10,13,4582319,48,88,4.0,28,0.318181818,1,9.480555556,160.531,118.25,40,58.333333333333336,20
1140,3321615,4,5,9,45,5180625,81,151,4.041666667,38,0.251655629,1,4.346388889,135.287,90.10526316,70,46.913580246913575,43
1141,3299607,1,5,13,50,3289170,11,74,5.0,2,0.027027027000000002,1,0.982222222,17.292,159.5,63,18.181818181818183,9
1142,3252143,5,5,17,59,4725370,15,203,5.0,3,0.014778325,1,0.671388889,7.817,69.33333333,188,20.0,12
1143,3227153,2,5,19,52,5100651,12,59,4.2,6,0.101694915,1,2.031388889,40.367,133.0,47,50.0,6
1144,3195850,7,5,20,44,5016162,26,70,4.333333333,20,0.28571428600000004,1,4.228888888999999,99.895,112.9,44,76.92307692307693,6
1145,3153368,3,5,9,49,5100476,24,45,4.214285714,21,0.46666666700000003,1,4.420555556,82.773,92.47619048,21,87.5,3
1146,3145120,1,5,13,43,3773814,28,58,5.0,6,0.10344827599999999,1,1.144722222,20.504,85.0,30,21.428571428571427,22
1147,3132920,3,5,16,58,4879214,43,110,4.454545455,34,0.30909090899999997,1,10.26111111,178.977,114.9705882,67,79.06976744186046,9
1148,3119763,1,5,10,33,4123674,22,54,3.5555555560000003,21,0.38888888899999996,1,7.583611111000001,135.732,128.6666667,32,95.45454545454545,1
1149,3075437,2,5,10,7,5191826,41,87,4.166666667,19,0.218390805,1,3.835277778,79.949,97.36842105,46,46.34146341463415,22
1150,2983535,3,5,15,2,4919346,8,42,5.0,4,0.095238095,1,0.635555556,10.595999999999998,77.0,34,50.0,4
1151,2974881,4,5,9,31,5345274,63,167,3.7037037039999996,46,0.275449102,1,14.7775,239.825,114.47826090000002,104,73.01587301587301,17
1152,2956093,5,5,22,26,4694747,18,33,3.8,8,0.24242424199999998,1,1.988055556,46.101000000000006,127.0,15,44.44444444444444,10
1153,2944084,3,5,9,2,3711014,11,22,4.714285714,10,0.454545455,1,4.0594444439999995,48.276,105.7,11,90.9090909090909,1
1154,2931665,4,5,19,41,3741012,11,111,4.333333333,5,0.045045045,1,1.042222222,17.755,83.8,100,45.45454545454545,6
1155,2931517,3,5,17,53,4109690,24,109,4.3,21,0.19266055,1,8.069166667000001,131.904,125.2380952,85,87.5,3
1156,2930333,3,5,7,34,5077850,14,127,4.0,3,0.023622047,1,0.309166667,8.521,81.66666667,113,21.428571428571427,11
1157,2930265,2,5,21,40,4801334,18,22,2.8,15,0.681818182,1,3.4677777780000003,59.036,91.86666667,4,83.33333333333334,3
1158,2915025,1,5,5,53,4710720,29,67,3.8,14,0.208955224,1,3.212777778,64.275,102.2857143,38,48.275862068965516,15
1159,2869204,5,5,16,21,5236165,47,99,4.571428571,40,0.40404040399999996,1,9.715277777999999,169.602,95.125,52,85.1063829787234,7
1160,5419079,5,4,20,17,4857021,25,58,2.625,20,0.344827586,1,5.821666667000001,105.204,117.0,33,80.0,5
1161,5419022,7,4,16,36,4680924,53,84,4.5,42,0.5,1,10.19555556,187.851,102.09523809999999,31,79.24528301886792,11
1162,5418551,7,4,14,13,3841657,32,56,4.6428571430000005,25,0.446428571,1,4.921111111,95.895,91.52,24,78.125,7
1163,5418268,4,4,13,29,4595715,30,184,4.75,20,0.10869565199999999,1,4.816944444,99.971,108.4,154,66.66666666666666,10
1164,5415030,6,4,17,41,5368908,60,279,4.153846154,34,0.12186379900000001,1,7.380833332999999,133.268,97.52941176,219,56.666666666666664,26
1165,5412769,5,4,17,34,5331243,32,94,4.444444444,23,0.244680851,1,8.255277778,154.83100000000002,134.3913043,62,71.875,9
1166,5412629,4,4,16,33,5410901,11,26,5.0,8,0.307692308,1,2.323888889,36.0,98.375,15,72.72727272727273,3
1167,5412213,6,4,17,44,4937611,40,127,4.1428571430000005,28,0.22047244100000002,1,8.848611111,153.865,117.1428571,87,70.0,12
1168,5411518,4,4,19,50,4884191,22,59,4.0,8,0.13559322,1,2.181111111,42.489,116.25,37,36.36363636363637,14
1169,5411497,7,4,17,50,3815028,18,25,3.888888889,16,0.64,1,3.54,71.53,98.3125,7,88.88888888888889,2
1170,5410571,5,4,16,49,4404188,26,108,4.0,18,0.166666667,1,3.9077777780000003,57.041000000000004,80.38888889,82,69.23076923076923,8
1171,5410319,4,4,10,26,5390574,39,110,3.666666667,25,0.22727272699999998,1,6.711111111,107.648,100.32,71,64.1025641025641,14
1172,5409918,4,4,19,58,5372694,43,99,4.166666667,36,0.363636364,1,11.13583333,177.51,109.08333329999999,56,83.72093023255815,7
1173,5409403,5,4,23,41,3987360,27,89,3.8,23,0.25842696600000004,1,5.376666667,111.61200000000001,112.0,62,85.18518518518519,4
1174,5405671,7,4,16,54,3172562,10,19,5.0,3,0.15789473699999998,1,18.64277778,13.41,100.33333329999999,9,30.0,7
1175,5405081,6,4,17,41,4430652,33,59,4.666666667,20,0.33898305100000004,1,6.194444444,102.602,109.9,26,60.60606060606061,13
1176,5404962,7,4,17,20,5211536,42,77,4.117647058999999,29,0.37662337700000004,1,6.3666666670000005,124.42399999999999,101.3793103,35,69.04761904761905,13
1177,5404941,5,4,18,50,3758308,25,27,4.214285714,23,0.851851852,1,6.187222222000001,120.176,112.7391304,2,92.0,2
1178,5404860,5,4,19,53,5210702,15,47,4.4,11,0.23404255300000001,1,2.113055556,45.677,96.09090909,32,73.33333333333333,4
1179,5404832,3,4,9,58,4039524,19,274,4.666666667,15,0.054744525999999995,1,4.925277778,71.44800000000001,110.0,255,78.94736842105263,4
1180,5403740,5,4,20,5,4618073,11,24,3.714285714,10,0.41666666700000005,1,0.5225,30.021,82.1,13,90.9090909090909,1
1181,5402976,4,4,4,56,3977196,18,41,3.428571429,13,0.31707317100000004,1,3.7794444439999997,64.774,117.6923077,23,72.22222222222221,5
1182,5402110,7,4,12,47,4925434,27,51,4.5,22,0.431372549,1,6.681944444,116.535,110.5909091,24,81.48148148148148,5
1183,5401593,4,4,10,22,3135851,42,64,4.3636363639999995,36,0.5625,1,8.716944444,129.345,86.88888889,22,85.71428571428571,6
1184,5397221,3,4,13,40,4559185,28,76,4.222222222,22,0.289473684,1,8.229166667000001,123.744,119.0,48,78.57142857142857,6
1185,5396523,2,4,10,46,4192108,22,34,4.6,16,0.470588235,1,3.846666667,72.84100000000001,100.3125,12,72.72727272727273,6
1186,5396407,2,4,17,30,4732905,16,84,4.571428571,12,0.14285714300000002,1,2.5575,37.135999999999996,79.41666667,68,75.0,4
1187,5396058,4,4,10,32,3804451,31,102,4.769230769,24,0.235294118,1,5.776666667000001,96.39200000000001,92.41666667,71,77.41935483870968,7
1188,5395744,7,4,12,41,3315958,12,118,4.285714286,10,0.084745763,1,3.148611111,57.318000000000005,114.9,106,83.33333333333334,2
1189,5395083,4,4,15,24,3564977,46,159,4.352941176,32,0.20125786199999998,1,7.429444444,145.703,103.03125,113,69.56521739130434,14
1190,5389047,2,4,21,42,4035872,62,132,4.62962963,49,0.371212121,1,9.634166667,177.697,87.67346939,70,79.03225806451613,13
1191,5388708,5,4,10,37,5202768,23,212,4.75,7,0.033018868,1,1.5772222219999998,22.377,81.28571429,189,30.434782608695656,16
1192,5387842,6,4,8,59,3516350,105,187,4.148148148,63,0.336898396,1,12.25944444,224.903,91.19047619,82,60.0,42
1193,5385546,2,4,11,32,4552191,9,101,4.666666667,6,0.059405941,1,1.9422222219999998,31.478,110.16666670000001,92,66.66666666666666,3
1194,5385040,3,4,7,41,4184776,28,132,5.0,6,0.045454545,1,1.169722222,19.087,85.66666667,104,21.428571428571427,22
1195,5383432,2,4,12,54,4175315,49,61,4.333333333,42,0.68852459,1,10.53805556,183.515,99.45238095,12,85.71428571428571,7
1196,5383418,3,4,10,18,5409882,30,60,5.0,4,0.066666667,1,0.253333333,3.4419999999999997,53.0,30,13.333333333333334,26
1197,5382753,3,4,12,34,4770624,15,79,4.833333333,12,0.151898734,1,3.024722222,56.869,105.41666670000001,64,80.0,3
1198,5381928,3,4,17,16,4765386,35,57,4.1111111110000005,19,0.333333333,1,5.705277777999999,90.574,106.31578950000001,22,54.285714285714285,16
1199,5381739,2,4,17,52,4267763,52,167,4.153846154,31,0.185628743,1,5.836666667,84.60799999999999,74.96774194,115,59.61538461538461,21
1200,5381282,2,4,11,39,5217612,24,83,4.2,19,0.22891566300000002,1,2.642222222,63.199,83.73684211,59,79.16666666666666,5
1201,5381165,1,4,20,32,3063549,63,97,4.2380952380000005,43,0.443298969,1,10.7475,201.24099999999999,101.06976740000002,34,68.25396825396825,20
1202,5380760,3,4,21,58,4771853,24,35,4.0,20,0.571428571,1,5.9058333329999995,103.58200000000001,115.75,11,83.33333333333334,4
1203,5378395,5,4,18,24,5031216,26,71,4.1428571430000005,24,0.338028169,1,4.721111111,105.194,101.29166670000001,45,92.3076923076923,2
1204,5375830,4,4,16,32,3112814,14,31,4.2,12,0.387096774,1,2.7,46.571000000000005,90.08333333,17,85.71428571428571,2
1205,5375135,5,4,17,5,5172541,18,44,4.375,14,0.318181818,1,3.162222222,58.18600000000001,94.57142857,26,77.77777777777779,4
1206,5374413,1,4,16,21,5259479,23,65,5.0,5,0.076923077,1,0.0044444440000000005,34.705,149.0,42,21.73913043478261,18
1207,5373787,3,4,9,8,4520377,22,34,3.857142857,21,0.6176470589999999,1,5.146388889,81.62,90.71428571,12,95.45454545454545,1
1208,5373585,5,4,20,23,4879543,43,136,4.0,23,0.16911764699999998,1,2.7366666669999997,53.278,74.0,93,53.48837209302325,20
1209,5368808,3,4,17,15,5197988,17,47,4.166666667,10,0.212765957,1,2.4225,45.071999999999996,101.1,30,58.82352941176471,7
1210,5368352,2,4,14,58,4027492,20,44,2.333333333,10,0.22727272699999998,1,2.876111111,35.681999999999995,90.5,24,50.0,10
1211,5367923,7,4,7,18,4808305,28,129,4.444444444,23,0.17829457399999998,1,8.415833333,157.11,134.69565219999998,101,82.14285714285714,5
1212,5367468,7,4,15,58,3402025,35,78,4.5,23,0.294871795,1,6.0125,111.705,102.7391304,43,65.71428571428571,12
1213,5366284,3,4,20,37,3665919,9,70,4.0,5,0.071428571,1,1.181944444,33.704,137.6,61,55.55555555555556,4
1214,5363499,3,4,11,28,5061447,20,47,4.333333333,12,0.25531914899999997,1,4.376111111,67.706,119.16666670000001,27,60.0,8
1215,5361875,2,4,12,8,5189444,17,175,4.5,8,0.04571428599999999,1,1.7191666669999999,27.579,92.0,158,47.05882352941176,9
1216,5361053,1,4,14,3,3644545,33,68,4.428571429,24,0.352941176,1,6.69,111.311,102.58333329999999,35,72.72727272727273,9
1217,5359958,1,4,12,23,4124791,40,72,4.25,27,0.375,1,8.1475,123.745,101.5185185,32,67.5,13
1218,5359667,3,4,17,2,5131110,24,75,4.333333333,16,0.213333333,1,5.3327777780000005,100.77799999999999,127.1875,51,66.66666666666666,8
1219,5358404,1,4,11,17,4552346,16,17,4.125,13,0.764705882,1,4.2302777780000005,66.501,107.7692308,1,81.25,3
1220,5354672,5,4,14,13,4780187,51,109,4.666666667,38,0.348623853,1,10.51361111,194.998,109.84210530000001,58,74.50980392156863,13
1221,5348109,1,4,10,48,4743266,15,36,4.833333333,10,0.27777777800000003,1,3.0752777780000002,53.702,115.8,21,66.66666666666666,5
1222,5348096,7,4,23,18,4723617,40,62,4.3571428569999995,30,0.48387096799999996,1,6.5025,137.533,105.9,22,75.0,10
1223,5347610,3,4,13,31,5181838,25,29,4.666666667,20,0.689655172,1,6.659444444,105.96700000000001,111.5,4,80.0,5
1224,5347050,2,4,19,36,3990631,24,57,5.0,15,0.263157895,1,3.1836111110000003,53.581,86.53333333,33,62.5,9
1225,5346792,3,4,17,34,4666657,38,75,3.8181818180000002,22,0.29333333300000003,1,7.091666667,107.706,106.5,37,57.89473684210527,16
1226,5346381,3,4,13,13,4914435,35,35,4.5,30,0.857142857,1,6.355,93.15899999999999,79.2,0,85.71428571428571,5
1227,5345600,3,4,10,46,4163143,57,98,4.1111111110000005,43,0.43877551,1,9.934166667000001,166.438,91.0,41,75.43859649122807,14
1228,5340814,5,4,21,42,3655713,14,49,4.625,12,0.244897959,1,2.730833333,62.0,117.58333329999999,35,85.71428571428571,2
1229,5339448,5,4,19,12,4780652,21,50,4.444444444,14,0.28,1,3.2997222219999998,62.986000000000004,108.0,29,66.66666666666666,7
1230,5334103,3,4,11,5,5259360,9,21,5.0,2,0.095238095,0,0.6075,8.785,96.0,12,22.22222222222222,7
1231,5333144,7,4,12,10,4556505,10,115,4.0,2,0.017391304,1,0.48916666700000005,11.27,112.5,105,20.0,8
1232,5331692,2,4,19,15,4570875,38,159,4.2,28,0.17610062899999998,1,7.67,134.596,105.1428571,121,73.68421052631578,10
1233,5329329,3,4,11,14,5347910,8,71,4.333333333,6,0.08450704199999999,1,1.038333333,20.623,89.0,63,75.0,2
1234,5327331,1,4,9,39,5375024,33,70,3.5,8,0.11428571400000001,1,2.176111111,45.292,120.5,37,24.242424242424242,25
1235,5324858,7,4,15,4,3175601,15,32,4.5,12,0.375,1,1.309166667,35.251999999999995,79.91666667,17,80.0,3
1236,5324317,2,4,8,6,3493100,20,26,3.0,14,0.538461538,1,4.801666667,80.907,119.57142859999999,6,70.0,6
1237,5319237,1,4,8,36,5393986,21,191,4.0,14,0.073298429,1,2.2480555559999997,44.758,83.71428571,170,66.66666666666666,7
1238,5318723,4,4,18,28,3518671,7,15,4.666666667,5,0.333333333,1,0.7433333329999999,15.935,87.0,8,71.42857142857143,2
1239,5318423,4,4,20,42,4522349,37,87,4.333333333,30,0.344827586,1,5.232777778,95.441,82.16666667,50,81.08108108108108,7
1240,5317704,2,4,17,56,4834926,32,57,3.8,13,0.228070175,1,4.6444444439999995,71.765,114.5384615,25,40.625,19
1241,5317602,2,4,17,17,4795867,24,29,4.571428571,19,0.655172414,1,5.278333333,68.038,85.21052632,5,79.16666666666666,5
1242,5317468,1,4,19,10,4792606,46,132,4.846153846,30,0.22727272699999998,1,8.568055556000001,119.646,94.1,86,65.21739130434783,16
1243,5317450,5,4,9,43,4408837,53,82,4.2,25,0.304878049,1,6.822222222000001,122.279,109.92,29,47.16981132075472,28
1244,5315004,2,4,5,57,5293488,31,100,3.5,7,0.07,1,0.009444444,4.916,50.57142857,69,22.58064516129032,24
1245,5312625,7,4,21,41,4917562,13,48,4.666666667,8,0.166666667,1,1.5919444440000001,32.533,103.0,35,61.53846153846154,5
1246,5310997,6,4,14,24,4652477,16,110,4.0,6,0.054545455,1,1.863055556,25.358,97.33333333,94,37.5,10
1247,5310519,1,4,20,34,4930864,32,81,4.6,24,0.296296296,1,7.2361111110000005,146.124,124.375,49,75.0,8
1248,5304718,5,4,9,32,3070504,62,78,4.5,38,0.487179487,1,12.53805556,208.84400000000002,112.7894737,16,61.29032258064516,24
1249,5303372,5,4,6,9,4633699,42,100,4.0,25,0.25,1,4.208055556000001,84.874,91.48,58,59.523809523809526,17
1250,5302762,1,4,20,21,4344763,24,30,4.625,17,0.566666667,1,3.858611111,72.822,98.82352941,6,70.83333333333334,7
1251,5302455,1,4,14,29,4479603,28,137,3.833333333,14,0.102189781,1,5.835833332999999,93.876,134.78571430000002,109,50.0,14
1252,5296605,1,4,8,26,4261837,55,72,4.476190476,45,0.625,1,14.0525,237.33700000000002,112.2222222,17,81.81818181818183,10
1253,5295327,5,4,16,59,4200991,48,57,4.266666667,34,0.596491228,1,9.39,149.614,99.02941176,9,70.83333333333334,14
1254,5295158,3,4,16,49,5402287,38,94,4.1,29,0.308510638,1,8.862777778,135.722,103.48275859999998,56,76.31578947368422,9
1255,5289711,4,4,16,59,4403136,20,38,4.727272727,17,0.447368421,1,6.3225,100.7,123.8235294,18,85.0,3
1256,5289067,1,4,12,32,3754371,29,50,3.8181818180000002,16,0.32,1,2.271666667,38.193000000000005,73.4375,21,55.172413793103445,13
1257,5287180,6,4,11,51,3532588,9,27,4.666666667,5,0.185185185,1,1.413611111,24.605999999999998,106.0,18,55.55555555555556,4
1258,5286887,1,4,19,21,4622500,8,171,4.0,4,0.023391812999999997,1,0.6930555559999999,14.424000000000001,88.5,163,50.0,4
1259,5286799,1,4,10,30,3700667,9,40,5.0,5,0.125,1,1.100833333,22.092,100.4,31,55.55555555555556,4
1260,5286519,2,4,12,44,4209684,20,30,4.5,6,0.2,1,1.4327777780000002,26.363000000000003,99.33333333,10,30.0,14
1261,5273180,2,4,6,2,4580979,71,186,3.939393939,60,0.322580645,1,13.17333333,286.469,104.5666667,115,84.50704225352112,11
1262,5272414,4,4,17,54,4555775,25,39,3.888888889,18,0.46153846200000004,1,5.298055556,95.29899999999999,112.33333329999999,14,72.0,7
1263,5272393,4,4,21,7,5264878,14,85,5.0,10,0.117647059,1,2.466111111,44.85,101.8,71,71.42857142857143,4
1264,5272224,3,4,9,12,4972194,23,58,4.545454545,20,0.344827586,1,6.4825,98.728,109.35,35,86.95652173913044,3
1265,5271863,4,4,14,2,4700421,44,68,4.4,26,0.382352941,1,9.076944444,125.93,103.88461540000002,24,59.09090909090909,18
1266,5266108,7,4,14,21,4595693,23,59,4.25,19,0.322033898,1,4.893055556,76.245,92.47368421,36,82.6086956521739,4
1267,5265927,4,4,19,57,4714660,5,81,4.5,4,0.04938271599999999,1,0.9902777779999999,17.519000000000002,106.0,76,80.0,1
1268,5258650,5,4,10,53,4483973,27,115,3.75,6,0.052173912999999995,1,1.812777778,23.674,96.66666667,88,22.22222222222222,21
1269,5257385,2,4,16,52,3652821,39,89,3.5,28,0.314606742,1,4.979166667,86.633,82.57142857,50,71.7948717948718,11
1270,5256940,3,4,11,59,4105079,48,66,4.538461538,33,0.5,1,9.116944444,145.481,97.84848485,18,68.75,15
1271,5255956,4,4,17,55,4341205,29,53,4.444444444,16,0.301886792,1,4.678055556,70.2,101.0625,24,55.172413793103445,13
1272,5255324,1,4,10,1,3985734,34,312,4.666666667,20,0.064102564,1,3.5513888889999996,78.611,91.75,278,58.82352941176471,14
1273,5255185,2,4,19,29,5406719,8,53,5.0,2,0.037735849,1,0.6466666670000001,11.568,122.5,45,25.0,6
1274,5254892,1,4,11,54,5331407,21,43,4.555555556,15,0.348837209,1,3.921111111,55.501000000000005,90.0,22,71.42857142857143,6
1275,5254568,2,4,15,21,4356551,9,89,3.666666667,8,0.08988764,1,3.45,56.387,135.0,80,88.88888888888889,1
1276,5252394,2,4,8,59,4598266,18,104,3.833333333,16,0.153846154,1,4.1325,78.847,106.0,86,88.88888888888889,2
1277,5251178,2,4,10,10,3235473,60,69,4.6071428569999995,47,0.68115942,1,13.63027778,222.995,102.3829787,9,78.33333333333333,13
1278,5251049,2,4,18,59,5179248,21,70,4.75,20,0.28571428600000004,1,5.278055556,88.773,98.9,49,95.23809523809523,1
1279,5250661,1,4,9,33,3445230,19,62,3.666666667,6,0.09677419400000001,1,1.628888889,28.267,101.66666670000001,43,31.57894736842105,13
1280,5250420,3,4,17,51,5413347,22,40,3.8,16,0.4,1,4.4675,61.827,89.5,18,72.72727272727273,6
1281,5249989,7,4,17,40,3087357,46,69,4.375,34,0.492753623,1,9.606388889,175.308,110.0,23,73.91304347826086,12
1282,5248892,1,4,13,12,3369700,18,71,4.333333333,7,0.098591549,1,1.918611111,32.754,100.1428571,53,38.88888888888889,11
1283,5248864,5,4,18,2,4448154,42,66,4.461538462,33,0.5,1,8.896666667,125.691,92.51515152,24,78.57142857142857,9
1284,5248853,3,4,15,59,4874243,28,33,4.75,23,0.696969697,1,7.461388889,119.787,111.9130435,5,82.14285714285714,5
1285,5248382,1,4,12,8,4069405,34,100,4.125,13,0.13,1,6.838888889,95.48899999999999,150.84615380000002,66,38.23529411764706,21
1286,5247802,6,4,15,10,4036056,19,100,4.538461538,15,0.15,1,5.217222222,85.964,120.06666670000001,81,78.94736842105263,4
1287,5244851,4,4,20,42,3212710,31,292,2.5,2,0.006849315,1,0.350555556,6.737,94.5,261,6.451612903225806,29
1288,5239971,2,4,18,31,3162368,58,103,4.058823529,42,0.40776699,1,12.3725,229.081,113.33333329999999,45,72.41379310344827,16
1289,5239462,7,4,17,24,4044136,19,39,4.6,14,0.35897435899999997,1,3.914166667,83.479,121.07142859999999,20,73.68421052631578,5
1290,5236416,5,4,9,34,3922981,11,88,4.666666667,9,0.102272727,1,4.078611111,82.23299999999999,166.88888889999998,77,81.81818181818183,2
1291,5230954,1,4,10,20,4278997,7,14,5.0,5,0.35714285700000004,1,1.4552777780000001,24.208000000000002,109.6,7,71.42857142857143,2
1292,5227489,2,4,15,15,4972653,29,51,4.0,17,0.333333333,1,4.558055556,66.61399999999999,89.76470588,22,58.620689655172406,12
1293,5227428,6,4,21,15,4535360,18,53,4.583333333,13,0.245283019,1,3.513888889,62.353,104.4615385,35,72.22222222222221,5
1294,5226907,3,4,9,39,5203628,50,87,4.666666667,23,0.26436781600000003,1,5.751666667,102.25,101.56521740000001,37,46.0,27
1295,5226726,3,4,11,54,4718729,37,187,4.416666667,22,0.117647059,1,5.950277777999999,93.524,95.40909091,150,59.45945945945946,15
1296,5226268,4,4,18,38,5000903,18,30,3.857142857,13,0.433333333,1,3.125,51.245,98.0,12,72.22222222222221,5
1297,5220022,4,4,20,19,5295361,6,29,4.0,4,0.137931034,1,1.478888889,30.026999999999997,160.0,23,66.66666666666666,2
1298,5219843,2,4,16,56,4968756,38,60,4.666666667,29,0.483333333,1,6.596944444,126.164,99.62068966,22,76.31578947368422,9
1299,5218774,1,4,16,53,4542608,16,109,4.333333333,12,0.110091743,1,2.745277778,40.865,83.16666667,93,75.0,4
1300,5218407,1,4,19,9,5080218,17,56,3.428571429,16,0.28571428600000004,1,2.8002777780000003,49.602,76.375,39,94.11764705882352,1
1301,5217382,2,4,7,20,5401394,14,31,4.666666667,7,0.225806452,1,1.49,38.067,112.1428571,17,50.0,7
1302,5214903,6,4,18,18,4822181,13,128,4.5,3,0.0234375,1,0.9177777779999999,15.327,113.0,115,23.076923076923077,10
1303,5212708,1,4,6,31,4514474,38,61,4.5625,25,0.409836066,1,6.043333333,99.48200000000001,90.64,23,65.78947368421053,13
1304,5212475,2,4,15,3,3877500,36,70,4.545454545,22,0.314285714,1,9.246388889,131.938,120.81818179999999,34,61.111111111111114,14
1305,5212248,4,4,17,3,5306991,68,89,4.0,37,0.415730337,1,9.931388888999999,171.13400000000001,104.0540541,21,54.41176470588235,31
1306,5211966,3,4,17,23,5017066,21,119,4.8,11,0.092436975,1,14.37666667,58.412,113.0909091,98,52.38095238095239,10
1307,5208572,4,4,20,12,5267258,38,91,4.230769231,30,0.32967033,1,8.715555556,155.389,115.3,53,78.94736842105263,8
1308,5208543,1,4,15,26,5112258,37,55,4.166666667,30,0.545454545,1,8.011388889,129.542,97.26666667,18,81.08108108108108,7
1309,5207903,1,4,19,46,3622937,41,49,4.45,33,0.673469388,1,9.589722222,135.47799999999998,95.21212121,8,80.48780487804879,8
1310,5206985,3,4,13,21,5407824,16,24,4.1428571430000005,14,0.583333333,1,3.581944444,67.779,106.1428571,8,87.5,2
1311,5206216,2,4,16,12,4831463,59,101,4.318181818,40,0.396039604,1,11.82111111,183.28799999999998,101.4,42,67.79661016949152,19
1312,5206133,2,4,11,20,4486470,30,66,4.538461538,25,0.378787879,1,6.637777777999999,91.389,88.72,36,83.33333333333334,5
1313,5205524,2,4,10,30,4874374,74,109,4.56,50,0.458715596,1,13.62055556,204.75,97.12,35,67.56756756756756,24
1314,5204615,2,4,12,16,5175756,39,50,4.818181818,19,0.38,1,4.898611111,83.15100000000001,101.1578947,11,48.717948717948715,20
1315,5202811,4,4,7,5,4716940,37,90,4.6428571430000005,26,0.288888889,1,7.295555556,143.249,115.5384615,53,70.27027027027027,11
1316,5197333,4,4,21,38,4339021,46,58,4.545454545,43,0.74137931,1,9.707222222,206.072,108.25581399999999,12,93.47826086956522,3
1317,5196043,1,4,16,21,3896621,24,146,4.428571429,10,0.068493151,1,1.5872222219999998,30.456999999999997,77.7,122,41.66666666666667,14
1318,5193118,3,4,10,59,5148096,45,72,4.3888888889999995,37,0.513888889,1,10.08694444,174.428,105.3513514,27,82.22222222222221,8
1319,5180045,3,4,14,5,4902734,32,66,4.571428571,15,0.22727272699999998,1,3.4663888889999996,75.398,106.13333329999999,34,46.875,17
1320,5179681,5,4,11,49,3271279,36,94,4.416666667,28,0.29787234,1,9.0775,131.933,103.07142859999999,58,77.77777777777779,8
1321,5170190,3,4,12,55,3742883,31,44,4.75,19,0.43181818200000005,1,5.100555556000001,81.41,96.63157895,13,61.29032258064516,12
1322,5170112,1,4,7,29,3583987,21,31,3.8,18,0.580645161,1,4.0261111110000005,80.958,103.2222222,10,85.71428571428571,3
1323,5169488,1,4,10,19,3315190,31,50,4.266666667,25,0.5,1,7.321388889,114.04899999999999,109.12,19,80.64516129032258,6
1324,5169406,2,4,8,22,4210687,14,28,4.5,11,0.39285714299999996,1,2.5302777780000003,48.003,96.18181818,14,78.57142857142857,3
1325,5169362,2,4,12,48,5164620,24,45,4.5,16,0.355555556,1,4.848333333,79.348,104.875,21,66.66666666666666,8
1326,5169068,2,4,5,14,4383773,36,39,4.7647058819999994,29,0.7435897440000001,1,6.839166667000001,141.963,105.41379309999999,3,80.55555555555556,7
1327,5165758,2,4,11,19,3988923,23,76,4.714285714,15,0.19736842100000002,1,5.281388889,87.762,118.93333329999999,53,65.21739130434783,8
1328,5165202,3,4,18,6,4481596,12,18,4.428571429,11,0.611111111,1,3.688888889,48.799,99.0,6,91.66666666666666,1
1329,5160589,5,4,20,55,5037037,15,21,4.875,14,0.666666667,1,4.651388889,75.782,115.57142859999999,6,93.33333333333333,1
1330,5160491,5,4,16,58,3783556,8,69,4.307563701,2,0.028985507,1,0.2725,4.946000000000001,74.5,61,25.0,6
1331,5160367,3,4,17,16,4194448,15,51,4.571428571,14,0.27450980399999997,1,4.231666667,56.14,96.92857143,36,93.33333333333333,1
1332,5159456,1,4,12,39,3859567,19,32,4.6,9,0.28125,1,3.108055556,49.953,113.0,13,47.368421052631575,10
1333,5158083,3,4,9,55,5302806,31,167,4.1428571430000005,13,0.077844311,1,2.4130555559999998,32.162,70.23076923,136,41.935483870967744,18
1334,5157666,7,4,20,33,5338185,25,49,4.5,22,0.44897959200000004,1,6.6425,87.945,91.09090909,24,88.0,3
1335,5152599,3,4,9,49,4789667,13,83,4.833333333,11,0.13253012,1,3.834444444,64.995,123.7272727,70,84.61538461538461,2
1336,5151321,5,4,13,25,3388127,35,80,4.333333333,29,0.3625,1,8.191944443999999,138.03799999999998,103.55172409999999,45,82.85714285714286,6
1337,5143527,1,4,16,54,4627232,14,24,4.25,8,0.333333333,1,2.363055556,33.733000000000004,93.125,10,57.14285714285714,6
1338,5140837,5,4,17,4,4706380,38,92,4.3888888889999995,29,0.315217391,1,7.314444443999999,117.838,94.48275862,54,76.31578947368422,9
1339,5138442,3,4,16,12,4550189,42,71,4.45,36,0.507042254,1,8.8825,157.651,97.69444444,29,85.71428571428571,6
1340,5138232,4,4,16,17,4797573,25,58,4.222222222,20,0.344827586,1,5.101666667,95.837,106.35,33,80.0,5
1341,5137500,4,4,19,54,3814468,24,53,4.272727273,19,0.358490566,1,5.8897222220000005,114.49700000000001,126.4736842,29,79.16666666666666,5
1342,5132205,5,4,8,58,5369242,23,99,4.3636363639999995,17,0.171717172,1,3.2811111110000004,62.897,90.94117647,76,73.91304347826086,6
1343,5131392,1,4,18,4,4939776,25,55,4.545454545,21,0.381818182,1,3.1355555560000004,49.162,70.33333333,30,84.0,4
1344,5129379,1,4,10,38,4905916,18,35,4.166666667,9,0.257142857,1,2.578888889,44.9,111.33333329999999,17,50.0,9
1345,5126985,7,4,18,35,4758863,64,140,4.2,45,0.321428571,1,14.33722222,268.405,123.95555559999998,76,70.3125,19
1346,5125852,5,4,1,29,5242454,27,51,4.625,15,0.294117647,1,2.089722222,50.771,105.73333329999998,24,55.55555555555556,12
1347,5125164,5,4,19,16,4148594,13,117,3.666666667,7,0.05982906,1,2.429166667,37.44,114.2857143,104,53.84615384615385,6
1348,5124702,1,4,12,52,5291113,72,166,3.4444444439999997,45,0.271084337,1,12.55583333,180.49400000000003,93.42222222,94,62.5,27
1349,5123211,5,4,11,24,4761366,28,53,5.0,8,0.150943396,1,2.772777778,51.896,132.25,25,28.57142857142857,20
1350,5122991,5,4,13,36,5425916,30,45,4.8,15,0.333333333,1,1.949444444,46.798,85.93333333,15,50.0,15
1351,5122572,3,4,10,36,5271125,33,63,4.375,23,0.365079365,1,5.509444444,95.695,96.17391304,30,69.6969696969697,10
1352,5122098,7,4,18,57,4115556,26,49,4.0,7,0.14285714300000002,1,1.563333333,16.666,70.0,23,26.923076923076923,19
1353,5121722,7,4,12,48,5007387,29,43,4.272727273,22,0.511627907,1,7.25,123.962,122.4090909,14,75.86206896551724,7
1354,5116275,7,4,5,11,4819897,8,54,4.307563701,2,0.037037037,1,0.328611111,10.137,113.0,46,25.0,6
1355,5115065,3,4,20,23,3308505,17,76,4.0,8,0.10526315800000001,1,1.819166667,39.67,110.75,59,47.05882352941176,9
1356,5114152,2,4,17,49,4472226,13,59,4.75,11,0.186440678,1,3.080833333,47.038000000000004,101.5454545,46,84.61538461538461,2
1357,5113388,4,4,22,7,5008897,17,153,4.5,11,0.071895425,1,2.501666667,60.802,128.7272727,136,64.70588235294117,6
1358,5109000,3,4,18,55,4932829,12,26,4.666666667,10,0.384615385,1,3.414444444,67.02600000000001,132.4,14,83.33333333333334,2
1359,5108961,7,4,11,58,4435301,24,75,4.6,15,0.2,1,3.7011111110000003,74.48,105.66666670000001,51,62.5,9
1360,5108422,4,4,19,16,5376289,9,18,4.333333333,6,0.333333333,1,1.383055556,26.171,99.33333333,9,66.66666666666666,3
1361,5107555,2,4,20,35,5187448,17,30,4.8,11,0.36666666700000006,1,2.456666667,49.036,100.5454545,13,64.70588235294117,6
1362,5106492,5,4,15,9,5170334,60,98,3.952380952,47,0.479591837,1,13.13333333,223.046,102.7234043,38,78.33333333333333,13
1363,5105605,5,4,23,1,3995563,23,25,4.4,20,0.8,1,5.033055556,83.132,99.55,2,86.95652173913044,3
1364,5094786,4,4,17,32,3056108,26,55,4.428571429,14,0.254545455,1,5.063611111,85.045,128.0,29,53.84615384615385,12
1365,5083237,1,4,11,58,3836661,24,52,4.384615385,22,0.423076923,1,6.126944443999999,118.566,112.95454550000001,28,91.66666666666666,2
1366,5083225,1,4,12,42,3908463,15,47,4.0,1,0.021276596000000002,1,0.175555556,5.247000000000001,109.0,32,6.666666666666667,14
1367,5083194,1,4,12,4,4729894,17,24,3.777777778,17,0.708333333,1,6.323611111,102.289,124.1764706,7,100.0,0
1368,5081591,7,4,18,59,3221155,21,80,3.0,9,0.1125,1,2.374722222,31.23,83.88888889,59,42.857142857142854,12
1369,5076235,2,4,13,59,5052896,40,104,4.230769231,27,0.259615385,1,6.897777777999999,110.236,92.51851852,64,67.5,13
1370,5074906,3,4,10,6,3638206,20,48,4.4,11,0.229166667,1,4.495,68.866,129.0909091,28,55.00000000000001,9
1371,5069653,6,4,13,49,3617205,29,88,4.1428571430000005,23,0.261363636,1,7.663611111,131.768,120.65217390000001,59,79.3103448275862,6
1372,5069161,7,4,18,14,5130225,14,39,4.0,8,0.205128205,1,2.141111111,36.305,103.25,25,57.14285714285714,6
1373,5068523,1,4,14,32,5211563,11,62,4.833333333,9,0.14516129,1,2.066111111,42.585,105.7777778,51,81.81818181818183,2
1374,5066368,2,4,17,9,4952102,33,152,3.857142857,18,0.11842105300000001,1,4.099722222,45.826,72.55555556,119,54.54545454545454,15
1375,5060078,3,4,13,46,5407937,29,76,5.0,7,0.092105263,1,1.5577777780000002,44.288000000000004,125.57142859999999,47,24.137931034482758,22
1376,5057624,3,4,19,45,3460853,30,175,3.888888889,19,0.108571429,1,4.950277778,78.533,93.05263158,145,63.33333333333333,11
1377,5055770,7,4,13,32,4254815,15,93,4.0,8,0.086021505,1,2.1941666669999997,41.725,114.875,78,53.333333333333336,7
1378,5046468,3,4,9,4,5025131,21,28,4.0,18,0.642857143,1,5.745833332999999,100.544,116.8888889,7,85.71428571428571,3
1379,5046454,7,4,16,6,5387909,10,34,4.5,9,0.264705882,1,2.301944444,41.753,103.4444444,24,90.0,1
1380,5037205,1,4,7,50,4548437,43,73,4.777777778,32,0.438356164,1,7.329444444,130.118,92.09375,30,74.4186046511628,11
1381,5028829,4,4,12,15,4558595,25,99,4.6363636360000005,20,0.20202020199999998,1,6.6388888889999995,97.461,111.0,74,80.0,5
1382,5026201,1,4,12,11,4531570,29,43,4.384615385,24,0.558139535,1,6.666388888999999,110.46799999999999,100.58333329999999,14,82.75862068965517,5
1383,5018939,3,4,17,54,3511352,41,95,4.5,9,0.09473684199999999,1,4.158888889,76.34899999999999,163.66666669999998,54,21.951219512195124,32
1384,5007554,4,4,20,50,4522053,20,28,4.222222222,20,0.7142857140000001,1,4.9,119.109,125.25,8,100.0,0
1385,5006017,3,4,11,11,4996138,15,31,4.6,9,0.290322581,1,3.1125,45.343,106.0,16,60.0,6
1386,5004823,2,4,17,31,5268148,48,77,4.6,31,0.40259740299999996,1,10.81888889,178.713,119.80645159999999,29,64.58333333333334,17
1387,5004758,5,4,17,19,5417082,41,82,4.5,26,0.31707317100000004,1,6.388055556,112.385,95.23076923,41,63.41463414634146,15
1388,5003527,4,4,17,30,3846129,53,104,4.461538462,29,0.278846154,1,7.280277777999999,131.497,104.7931034,51,54.71698113207547,24
1389,5003073,5,4,16,7,3643918,46,76,4.416666667,30,0.39473684200000003,1,9.7,131.5,100.4,30,65.21739130434783,16
1390,4999479,1,4,20,23,5143541,39,96,4.470588235,32,0.333333333,1,8.628055556,137.093,95.875,57,82.05128205128204,7
1391,4986157,2,4,16,42,5394139,12,42,5.0,8,0.19047619,1,1.723333333,28.085,88.125,30,66.66666666666666,4
1392,4985131,5,4,9,32,3922286,20,132,4.8,12,0.090909091,1,3.606666667,54.403999999999996,100.75,112,60.0,8
1393,4981877,7,4,10,41,4987827,19,52,4.333333333,15,0.288461538,1,1.265555556,53.888000000000005,87.53333333,33,78.94736842105263,4
1394,4980336,5,4,21,24,5383749,57,87,3.888888889,39,0.448275862,1,1.105,44.776,58.15384615,30,68.42105263157895,18
1395,4973245,7,4,12,40,5139140,29,67,4.666666667,17,0.253731343,1,3.9475,74.542,99.47058824,38,58.620689655172406,12
1396,4970946,3,4,19,59,3643381,15,55,3.333333333,11,0.2,1,1.9775,47.085,99.18181818,40,73.33333333333333,4
1397,4968810,4,4,15,59,5354220,36,106,4.0,26,0.245283019,1,3.330555556,117.3,104.2307692,70,72.22222222222221,10
1398,4966506,4,4,17,46,5323079,13,38,4.0,12,0.31578947399999996,1,3.2655555560000002,55.669,104.66666670000001,25,92.3076923076923,1
1399,4965822,3,4,15,22,4551613,46,135,4.277777778,35,0.25925925899999996,1,12.00138889,206.611,122.77142859999998,89,76.08695652173914,11
1400,4965793,7,4,11,5,5424843,7,59,5.0,2,0.033898305,1,0.473888889,13.68,146.0,52,28.57142857142857,5
1401,4960834,3,4,13,41,4720049,13,30,5.0,3,0.1,1,0.541666667,10.706,83.33333333,17,23.076923076923077,10
1402,4959710,2,4,14,35,4886853,65,103,4.5,47,0.45631068,1,15.28527778,266.915,118.4893617,38,72.3076923076923,18
1403,4946567,2,4,14,51,4624124,46,71,4.555555556,37,0.521126761,1,9.535277778,189.91,111.5135135,25,80.43478260869566,9
1404,4939884,3,4,18,55,4432512,13,49,4.5,6,0.12244898,1,1.5766666669999998,24.625,90.83333333,36,46.15384615384615,7
1405,4934573,7,4,18,38,5350504,20,102,4.166666667,11,0.10784313699999999,1,1.052222222,27.099,74.45454545,82,55.00000000000001,9
1406,4919916,2,4,20,17,5201539,41,123,4.1875,30,0.243902439,1,5.1925,94.721,78.66666667,82,73.17073170731707,11
1407,4915629,7,4,19,56,3827317,33,56,2.833333333,22,0.39285714299999996,1,5.1325,92.165,100.90909090000001,23,66.66666666666666,11
1408,4914425,1,4,11,36,5300906,16,20,4.666666667,9,0.45,1,2.436944444,43.823,106.2222222,4,56.25,7
1409,4913712,5,4,19,32,4147567,47,116,3.833333333,24,0.20689655199999998,1,7.153055556,122.285,107.70833329999999,69,51.06382978723404,23
1410,4899641,1,4,13,14,5241656,15,58,4.3,14,0.24137931,1,3.2686111110000002,47.742,85.42857143,43,93.33333333333333,1
1411,4898205,2,4,17,0,3548719,24,56,4.833333333,11,0.19642857100000002,1,4.0258333330000005,57.18,108.2727273,32,45.83333333333333,13
1412,4894087,1,4,20,32,5356781,37,47,4.705882353,28,0.595744681,1,9.105,153.333,113.8571429,10,75.67567567567568,9
1413,4888336,7,4,17,55,3643276,17,33,4.0,7,0.212121212,1,1.666944444,30.101,96.71428571,16,41.17647058823529,10
1414,4886574,5,4,12,45,3049246,36,55,4.333333333,10,0.181818182,1,3.438611111,58.893,121.1,19,27.77777777777778,26
1415,4881523,2,4,20,5,5271745,35,264,3.923076923,19,0.071969697,1,5.563888888999999,83.09299999999999,96.68421053,229,54.285714285714285,16
1416,4874971,3,4,20,15,3067181,41,66,4.066666667,35,0.53030303,1,9.296944444,148.391,96.65714286,25,85.36585365853658,6
1417,4874345,3,4,18,0,5164534,47,85,4.333333333,15,0.176470588,1,4.119444444,73.041,104.0,38,31.914893617021278,32
1418,4868634,2,4,10,4,5358579,11,38,3.666666667,8,0.21052631600000002,1,2.826666667,40.922,109.875,27,72.72727272727273,3
1419,4868279,5,4,14,57,3262973,31,73,4.571428571,19,0.260273973,1,5.900833333,98.759,109.36842109999999,42,61.29032258064516,12
1420,4867768,2,4,23,34,5097473,25,97,4.0,18,0.18556701,1,7.16,114.71600000000001,134.4444444,72,72.0,7
1421,4856793,3,4,22,33,5281577,21,37,4.333333333,12,0.324324324,1,3.8661111110000004,71.923,129.1666667,16,57.14285714285714,9
1422,4846985,5,4,18,12,5282580,26,41,4.454545455,20,0.487804878,1,5.773611111,89.189,102.35,15,76.92307692307693,6
1423,4844510,5,4,12,39,5372992,20,29,4.8,14,0.482758621,1,4.067222222,65.333,106.2857143,9,70.0,6
1424,4833776,4,4,19,27,4673932,29,60,4.05,26,0.433333333,1,6.677777777999999,130.81,110.7307692,31,89.65517241379311,3
1425,4831940,4,4,19,11,5069760,23,42,4.125,15,0.35714285700000004,1,3.5736111110000004,61.391000000000005,95.06666667,19,65.21739130434783,8
1426,4827065,3,4,12,7,5143793,25,90,3.75,11,0.12222222199999999,1,4.2930555560000005,70.219,128.0909091,65,44.0,14
1427,4826845,1,4,10,18,5281706,31,65,4.444444444,18,0.276923077,1,4.162777778,78.40899999999999,97.16666667,34,58.06451612903226,13
1428,4820689,5,4,14,33,5096660,29,78,4.833333333,17,0.217948718,1,1.574444444,32.007,64.76470588,49,58.620689655172406,12
1429,4808552,5,4,10,54,5111034,26,91,4.5,14,0.153846154,1,4.482777778,80.994,116.5,65,53.84615384615385,12
1430,4803987,7,4,13,59,4408730,25,31,4.1111111110000005,14,0.45161290299999995,1,5.729166667,61.132,100.6428571,6,56.00000000000001,11
1431,4802282,4,4,10,28,3842762,33,51,4.2,26,0.509803922,1,5.232222222,102.699,90.07692308,18,78.78787878787878,7
1432,4797560,4,4,16,21,4579146,17,30,4.4,12,0.4,1,4.918888889,58.928999999999995,104.16666670000001,13,70.58823529411765,5
1433,4797272,6,4,16,37,5286980,16,55,4.666666667,10,0.181818182,1,2.080277778,32.284,82.9,39,62.5,6
1434,4768438,4,4,9,31,5253460,41,103,4.3,22,0.21359223300000002,1,6.930833333,110.71799999999999,108.5909091,62,53.65853658536586,19
1435,4760071,7,4,16,38,5285962,18,35,4.166666667,11,0.314285714,1,3.795277778,64.782,121.18181820000001,17,61.111111111111114,7
1436,4753620,7,4,12,32,5286060,30,83,4.5,7,0.084337349,1,1.6166666669999998,26.416999999999998,88.28571429,53,23.333333333333332,23
1437,4753413,2,4,14,4,4552152,26,34,4.6,25,0.735294118,1,5.821944444,95.762,89.12,8,96.15384615384616,1
1438,4747985,7,4,17,56,5137831,38,82,4.125,24,0.292682927,1,6.511388889,109.818,104.75,44,63.1578947368421,14
1439,4746552,1,4,6,7,4910676,8,24,4.75,6,0.25,1,1.655,35.922,130.5,16,75.0,2
1440,4736784,1,4,8,50,3957598,15,39,4.5,11,0.282051282,1,4.656666667,61.548,116.45454550000001,24,73.33333333333333,4
1441,4725174,7,4,18,46,3933437,22,73,4.8888888889999995,19,0.260273973,1,4.975277778,112.95100000000001,121.73684209999999,51,86.36363636363636,3
1442,4721744,3,4,18,26,4464665,9,13,4.307563701,1,0.076923077,0,0.10361111099999999,2.673,70.0,4,11.11111111111111,8
1443,4718773,3,4,13,46,4557200,47,108,3.8461538460000004,31,0.287037037,1,8.880555556000001,140.688,100.4193548,61,65.95744680851064,16
1444,4706126,7,4,19,52,5274372,11,61,5.0,6,0.09836065599999999,1,0.268611111,16.005,72.33333333,50,54.54545454545454,5
1445,4699753,1,4,9,33,4537375,23,47,4.428571429,12,0.25531914899999997,1,2.768055556,54.277,106.66666670000001,24,52.17391304347826,11
1446,4691717,3,4,10,0,4511469,32,120,4.0,16,0.133333333,1,5.531388889,87.911,121.375,88,50.0,16
1447,4690931,4,4,17,36,5009736,6,45,3.0,5,0.111111111,1,1.307222222,23.101,102.2,39,83.33333333333334,1
1448,4677968,6,4,7,15,5327056,18,30,3.833333333,11,0.36666666700000006,1,1.9583333330000001,49.708999999999996,126.3636364,12,61.111111111111114,7
1449,4673275,3,4,11,36,5185001,42,76,4.153846154,24,0.31578947399999996,1,5.556111111,95.369,91.91666667,34,57.14285714285714,18
1450,4672644,7,4,17,35,4628838,37,82,4.090909091,32,0.39024390200000003,1,7.337222222,149.08,101.28125,45,86.48648648648648,5
1451,4656561,7,4,20,37,4406956,27,77,4.666666667,24,0.31168831199999997,1,6.989722222,112.04,101.79166670000001,50,88.88888888888889,3
1452,4656070,4,4,18,20,4847701,18,94,4.0,7,0.074468085,1,2.314166667,41.528999999999996,127.7142857,76,38.88888888888889,11
1453,4650888,4,4,14,18,4986734,18,171,4.875,11,0.064327485,1,3.378055556,58.188,111.81818179999999,153,61.111111111111114,7
1454,4643382,2,4,22,45,4605070,36,58,4.583333333,23,0.396551724,1,4.5175,121.041,118.17391299999998,22,63.888888888888886,13
1455,4640472,2,4,18,2,5195589,12,42,3.5,10,0.23809523800000001,1,2.6325,42.492,94.2,30,83.33333333333334,2
1456,4633171,7,4,20,7,5246029,17,32,4.666666667,14,0.4375,1,2.562777778,50.258,92.14285714,15,82.35294117647058,3
1457,4627263,4,4,10,28,3521338,14,94,4.5,5,0.053191489,1,1.4875,28.276,125.0,80,35.714285714285715,9
1458,4613032,6,4,21,6,4305331,44,57,4.769230769,24,0.42105263200000004,1,4.725555556000001,85.06299999999999,86.66666667,13,54.54545454545454,20
1459,4607384,4,4,18,35,3926093,13,58,3.375,12,0.20689655199999998,1,3.0922222219999997,38.179,87.33333333,45,92.3076923076923,1
1460,4604790,5,4,12,39,5157393,5,6,5.0,5,0.833333333,1,1.0525,23.410999999999998,112.8,1,100.0,0
1461,4604343,3,4,21,17,4983137,31,77,4.076923077,24,0.31168831199999997,1,4.906388889,104.303,109.0,46,77.41935483870968,7
1462,4599041,2,4,10,32,5402383,42,146,4.333333333,16,0.109589041,1,4.418888889,80.79,107.9375,104,38.095238095238095,26
1463,4579638,4,4,21,36,5276552,14,205,4.5,10,0.048780488,1,1.6322222219999998,33.306999999999995,88.6,191,71.42857142857143,4
1464,4579596,2,4,12,50,4500565,37,54,4.0,28,0.518518519,1,6.0708333329999995,133.398,110.6428571,17,75.67567567567568,9
1465,4571445,1,4,15,57,4241370,51,59,3.916666667,23,0.38983050799999996,1,3.225,64.986,76.52173913,8,45.09803921568628,28
1466,4571377,1,4,13,11,4547662,12,14,4.5,8,0.571428571,1,1.948611111,35.939,97.125,2,66.66666666666666,4
1467,4565751,7,4,19,48,3674771,13,65,5.0,8,0.123076923,1,2.896666667,48.836000000000006,121.25,52,61.53846153846154,5
1468,4553536,4,4,16,8,4060629,6,31,3.5,3,0.09677419400000001,0,0.000555556,1.413,45.0,25,50.0,3
1469,4537035,1,4,22,4,4406647,15,86,4.2,11,0.127906977,1,1.763333333,38.097,85.90909091,71,73.33333333333333,4
1470,4536733,3,4,20,2,3421130,21,62,4.5,8,0.129032258,1,2.008333333,35.63,106.375,41,38.095238095238095,13
1471,4529583,4,4,18,36,4242333,17,37,5.0,9,0.243243243,1,3.2372222219999998,42.956,110.1111111,20,52.94117647058824,8
1472,4525054,5,4,14,7,4210772,26,76,4.0,14,0.184210526,1,3.668333333,71.044,111.0,50,53.84615384615385,12
1473,4516025,5,4,16,29,3274972,30,65,4.222222222,22,0.33846153799999995,1,6.721944444,110.98700000000001,107.6363636,35,73.33333333333333,8
1474,4498853,6,4,17,28,5397719,38,123,4.777777778,21,0.17073170699999998,1,6.7130555560000005,104.839,109.57142859999999,85,55.26315789473685,17
1475,4498291,1,4,6,51,3539776,41,60,4.428571429,29,0.483333333,1,9.346944444,157.65,113.0689655,19,70.73170731707317,12
1476,4494042,2,4,10,56,3375562,23,74,4.833333333,18,0.243243243,1,5.542777778,83.955,101.88888890000001,51,78.26086956521739,5
1477,4493375,1,4,11,12,4967976,18,79,4.5,14,0.17721519,1,4.510277778,65.406,101.6428571,61,77.77777777777779,4
1478,4493103,4,4,17,31,4271673,14,52,4.8,12,0.23076923100000002,1,2.7580555560000004,49.70399999999999,94.0,38,85.71428571428571,2
1479,4489917,2,4,12,4,4751940,37,54,3.923076923,19,0.351851852,1,5.498611111000001,97.385,112.36842109999999,17,51.35135135135135,18
1480,4487174,1,4,12,47,3403332,10,50,4.2,8,0.16,1,3.085,43.92,111.75,40,80.0,2
1481,4486334,1,4,8,5,3715212,64,169,4.083333333,17,0.100591716,1,5.24,93.96700000000001,114.1764706,105,26.5625,47
1482,4466671,3,4,12,48,3484532,38,78,4.176470588,26,0.333333333,1,4.668611111000001,86.711,82.5,40,68.42105263157895,12
1483,4465526,2,4,15,21,5247971,19,67,4.6,12,0.179104478,1,3.141388889,58.867,105.58333329999999,48,63.1578947368421,7
1484,4449538,2,4,9,11,5401829,21,75,4.714285714,15,0.2,1,2.0638888890000002,48.533,85.33333333,54,71.42857142857143,6
1485,4443257,5,4,7,16,5230192,22,36,4.714285714,13,0.36111111100000004,1,1.913888889,53.628,95.38461538,14,59.09090909090909,9
1486,4428002,5,4,10,23,4540481,34,52,4.6875,26,0.5,1,5.7825,124.62200000000001,103.07692309999999,18,76.47058823529412,8
1487,4425941,5,4,14,33,4164764,33,65,4.375,15,0.23076923100000002,1,4.232777778,63.533,95.33333333,32,45.45454545454545,18
1488,4424724,2,4,15,2,3877692,18,38,4.25,16,0.42105263200000004,1,3.476666667,59.446000000000005,86.6875,20,88.88888888888889,2
1489,4424694,5,4,13,11,4067407,37,71,4.0,21,0.29577464800000003,1,5.317777778,83.02799999999999,92.76190476,34,56.75675675675676,16
1490,4420690,3,4,10,17,5262582,16,18,4.666666667,13,0.7222222220000001,1,3.683888889,50.217,90.30769231,2,81.25,3
1491,4420518,1,4,18,57,4724406,8,43,5.0,4,0.093023256,1,1.653055556,26.174,123.5,35,50.0,4
1492,4380414,3,4,12,13,4441924,22,71,4.166666667,12,0.169014085,1,32.28638889,61.763000000000005,114.33333329999999,49,54.54545454545454,10
1493,4374072,1,4,10,29,4925620,21,50,4.666666667,10,0.2,1,0.692222222,33.961999999999996,91.7,29,47.61904761904761,11
1494,4372753,7,4,12,41,4973636,37,51,4.090909091,28,0.5490196079999999,1,8.275277778,136.216,104.5,14,75.67567567567568,9
1495,4358498,5,4,16,53,4577846,8,56,4.0,4,0.071428571,1,1.285,21.423000000000002,113.5,48,50.0,4
1496,4348071,3,4,9,42,4552557,24,45,4.666666667,13,0.288888889,1,2.667222222,45.519,83.38461538,21,54.166666666666664,11
1497,4330985,1,4,18,50,4226976,16,54,4.8,8,0.148148148,1,2.411944444,46.166000000000004,120.375,38,50.0,8
1498,4329296,4,4,14,36,4629571,28,38,4.5,22,0.578947368,1,5.479444443999999,86.03399999999999,91.72727273,10,78.57142857142857,6
1499,4323329,2,4,11,46,5272593,54,85,4.652173913,44,0.517647059,1,11.50861111,202.73,102.1363636,31,81.48148148148148,10
1500,4313771,1,4,16,49,3577566,12,26,4.666666667,6,0.23076923100000002,1,1.176666667,21.316999999999997,84.16666667,14,50.0,6
1501,4305170,7,4,18,31,5442365,23,86,2.8,12,0.139534884,1,3.0927777780000003,46.352,90.91666667,63,52.17391304347826,11
1502,4304577,2,4,10,22,4612568,14,52,4.375,10,0.192307692,1,3.1519444439999997,55.99100000000001,121.1,38,71.42857142857143,4
1503,4303297,2,4,13,2,3269369,29,89,4.454545455,19,0.213483146,1,2.114444444,61.818999999999996,83.78947368,60,65.51724137931035,10
1504,4303264,6,4,21,40,4540034,14,30,4.625,9,0.3,1,2.022777778,36.015,98.0,16,64.28571428571429,5
1505,4263025,2,4,8,55,4240196,34,115,4.133333333,25,0.21739130399999998,1,8.255833333,151.543,122.92,81,73.52941176470588,9
1506,4226144,3,4,19,9,4500273,17,27,4.375,16,0.592592593,1,3.999722222,88.214,118.375,10,94.11764705882352,1
1507,4221617,3,4,11,22,3850195,18,107,2.5,5,0.046728972,1,0.840833333,35.158,152.2,89,27.77777777777778,13
1508,4211431,3,4,6,57,5374747,31,51,3.9090909089999997,29,0.568627451,1,7.544166667000001,152.164,111.2758621,20,93.54838709677419,2
1509,4186284,3,4,16,0,4183067,48,70,4.647058824,36,0.514285714,1,12.29138889,207.40599999999998,118.44444440000001,22,75.0,12
1510,4152817,4,4,9,2,3774553,10,33,4.5,8,0.24242424199999998,1,1.907222222,33.166,94.75,23,80.0,2
1511,4150138,2,4,10,43,4607868,11,26,4.4,6,0.23076923100000002,1,1.93,25.855999999999998,102.33333329999999,15,54.54545454545454,5
1512,4147509,3,4,18,21,4725399,11,110,4.5,11,0.1,1,3.692777778,51.776,101.18181820000001,99,100.0,0
1513,4129108,2,4,8,21,4824454,25,37,4.333333333,15,0.405405405,1,4.732777778,93.569,123.2,12,60.0,10
1514,4122673,7,4,9,32,3993964,10,65,4.307563701,2,0.030769231,1,0.875277778,15.42,156.5,55,20.0,8
1515,4121747,5,4,17,37,3933215,37,93,3.583333333,28,0.301075269,1,8.849722222,148.768,111.3571429,56,75.67567567567568,9
1516,4104491,2,4,16,25,5165850,16,49,4.571428571,11,0.22448979600000002,1,3.574166667,54.126999999999995,107.2727273,33,68.75,5
1517,4059435,7,4,13,22,5421558,39,137,4.4,28,0.204379562,1,10.30555556,177.71400000000003,126.92857140000001,98,71.7948717948718,11
1518,4051325,3,4,17,54,5275433,51,85,3.6363636360000005,23,0.270588235,1,0.430833333,30.54,59.91304348,34,45.09803921568628,28
1519,4045906,3,4,15,36,5412270,14,61,4.0,1,0.016393443,1,0.140833333,2.281,64.0,47,7.142857142857142,13
1520,4042710,2,4,10,17,3739097,44,140,4.0,14,0.1,1,3.5716666669999997,52.614,88.07142857,96,31.818181818181817,30
1521,4042294,2,4,15,57,5367044,27,62,4.3,18,0.290322581,1,7.510277778,138.186,152.66666669999998,35,66.66666666666666,9
1522,4040384,4,4,17,57,3719709,37,62,4.5,27,0.435483871,1,8.425277778,146.05200000000002,113.74074070000002,25,72.97297297297297,10
1523,4038070,3,4,13,6,4176161,13,44,4.5,11,0.25,1,3.8652777780000003,59.155,114.54545449999999,31,84.61538461538461,2
1524,4035212,2,4,13,27,3807788,20,25,4.166666667,17,0.68,1,3.257222222,62.81399999999999,87.64705882,5,85.0,3
1525,4020783,2,4,8,54,3733782,31,79,3.4,14,0.17721519,1,4.408333333,89.522,128.7857143,48,45.16129032258064,17
1526,4020072,4,4,13,2,3660424,13,53,5.0,5,0.09433962300000001,1,2.294722222,38.884,146.6,40,38.46153846153847,8
1527,4013916,5,4,17,17,5142856,16,49,4.1428571430000005,12,0.244897959,1,3.8863888889999996,62.255,114.75,33,75.0,4
1528,3994444,1,4,17,6,3481302,11,68,4.0,8,0.117647059,1,42.08833333,30.37,90.0,57,72.72727272727273,3
1529,3970204,3,4,10,19,5300496,26,60,4.6,10,0.166666667,1,3.3230555560000004,68.922,140.6,34,38.46153846153847,16
1530,3968305,2,4,23,4,3075435,15,17,4.833333333,12,0.705882353,1,1.7516666669999998,45.745,100.08333329999999,2,80.0,3
1531,3967187,2,4,16,10,4944639,22,33,4.5,11,0.333333333,1,3.0625,52.644,103.5454545,11,50.0,11
1532,3946994,5,4,6,43,4673324,35,67,4.571428571,30,0.447761194,1,5.903888889,133.11,106.36666670000001,32,85.71428571428571,5
1533,3918668,2,4,13,51,4616121,28,66,4.666666667,19,0.287878788,1,5.243611111,77.016,93.47368421,38,67.85714285714286,9
1534,3894433,7,4,15,20,5132250,10,130,4.5,5,0.038461537999999997,1,1.235555556,16.593,84.4,120,50.0,5
1535,3849877,5,4,14,11,4731110,7,33,4.0,5,0.151515152,1,0.867222222,16.516,81.2,26,71.42857142857143,2
1536,3838783,1,4,16,38,5309278,27,32,4.1875,26,0.8125,1,5.570555556,118.318,99.80769231,5,96.29629629629629,1
1537,3827325,1,4,15,0,4336349,44,63,3.833333333,28,0.444444444,1,6.0775,96.03,85.0,19,63.63636363636363,16
1538,3820991,7,4,17,12,4336389,29,96,4.0,22,0.229166667,1,2.9961111110000003,54.646,72.13636364,67,75.86206896551724,7
1539,3810107,1,4,8,52,5082082,38,64,4.5882352939999995,30,0.46875,1,7.733888889,152.19899999999998,109.9,26,78.94736842105263,8
1540,3688957,3,4,13,47,4944026,18,36,4.0,8,0.222222222,1,2.663888889,44.42100000000001,112.5,18,44.44444444444444,10
1541,3668460,1,4,21,27,5395780,15,53,4.75,10,0.188679245,1,2.400555556,50.232,108.0,38,66.66666666666666,5
1542,3635071,5,4,18,1,4804323,20,44,4.875,18,0.409090909,1,5.376944443999999,93.455,113.0,24,90.0,2
1543,3521193,5,4,17,45,5388840,13,45,2.8,8,0.177777778,1,4.208055556000001,73.69800000000001,173.0,32,61.53846153846154,5
1544,3475104,1,4,13,9,5354086,21,38,4.75,19,0.5,1,6.340833333,99.70700000000001,109.05263159999998,17,90.47619047619048,2
1545,3474657,7,4,14,41,5060128,16,71,4.307563701,6,0.08450704199999999,1,0.11916666699999999,9.925,62.66666667,55,37.5,10
1546,3439844,3,4,16,29,5369166,8,55,4.0,1,0.018181818,0,0.189722222,3.287,79.0,47,12.5,7
1547,3433573,3,4,10,48,3039756,27,69,4.333333333,20,0.289855072,1,5.6225,87.697,99.0,42,74.07407407407408,7
1548,3402457,6,4,12,13,5271745,19,55,5.0,7,0.127272727,1,2.76,39.336999999999996,119.57142859999999,36,36.84210526315789,12
1549,3367068,3,4,19,53,4540703,40,243,4.0,1,0.004115226,0,0.0011111110000000001,3.992,90.0,203,2.5,39
1550,3358770,5,4,13,42,3168628,19,38,4.4,15,0.39473684200000003,1,3.745833333,62.26,95.0,19,78.94736842105263,4
1551,3189411,2,4,8,0,4894837,35,97,4.307563701,2,0.020618557,1,0.22305555600000002,2.623,54.0,62,5.714285714285714,33
1552,3119416,2,4,14,37,5382360,36,129,4.2352941180000006,26,0.201550388,1,4.992222222,95.37,85.80769231,93,72.22222222222221,10
1553,3089358,2,4,18,26,4687943,15,40,4.666666667,6,0.15,1,1.467777778,31.934,110.0,25,40.0,9
1554,3019419,1,4,9,56,5092069,19,77,4.0,16,0.207792208,1,4.925277778,87.28299999999999,115.375,58,84.21052631578947,3
1555,2962047,2,4,11,23,3186922,26,56,4.2,18,0.321428571,1,5.405,88.584,106.44444440000001,30,69.23076923076923,8
1556,2949302,4,4,16,55,5418732,41,76,4.4,29,0.38157894700000006,1,9.696944444,157.451,119.03448279999999,35,70.73170731707317,12
1557,2939767,1,4,9,47,5381942,11,128,4.2,8,0.0625,1,2.4252777780000003,45.656000000000006,115.75,117,72.72727272727273,3
1558,2938121,2,4,20,52,3550772,63,94,4.333333333,50,0.531914894,1,16.23277778,235.748,104.24,31,79.36507936507937,13
1559,2937666,2,4,8,54,4210135,51,178,4.578947368,37,0.207865169,1,9.117777777999999,157.293,96.27027027,127,72.54901960784314,14
1560,2935294,7,4,20,18,4557909,28,68,4.461538462,25,0.367647059,1,5.1388888889999995,101.82700000000001,92.12,40,89.28571428571429,3
1561,5426857,7,3,17,41,5309149,22,53,4.666666667,17,0.32075471699999997,1,4.313055556,83.29700000000001,129.0,31,77.27272727272727,5
1562,5426850,7,3,14,10,4431669,15,123,4.2,8,0.06504065,1,1.4211111109999999,27.015,81.25,108,53.333333333333336,7
1563,5426739,7,3,14,57,4921911,21,114,4.166666667,12,0.10526315800000001,1,3.581944444,59.364,114.0,93,57.14285714285714,9
1564,5426523,6,3,21,23,5158032,14,114,4.25,10,0.087719298,1,2.2375,46.81399999999999,104.2,100,71.42857142857143,4
1565,5426155,6,3,13,29,4430621,23,80,4.75,22,0.275,1,7.653611111,113.10700000000001,112.0909091,57,95.65217391304348,1
1566,5426139,6,3,17,2,4322171,8,23,4.0,6,0.260869565,1,0.761111111,11.2,65.83333333,15,75.0,2
1567,5426112,7,3,19,33,4388082,21,33,4.0,15,0.454545455,1,4.365555556,70.78399999999999,105.2,12,71.42857142857143,6
1568,5425168,7,3,18,0,4892460,21,38,4.6,14,0.36842105299999994,1,4.619722222,76.844,117.07142859999999,17,66.66666666666666,7
1569,5425048,5,3,16,34,4154367,8,46,5.0,5,0.10869565199999999,1,1.0402777779999999,24.255,107.4,38,62.5,3
1570,5420621,5,3,17,47,3635353,23,101,4.125,11,0.108910891,1,2.514722222,38.652,86.81818182,78,47.82608695652174,12
1571,5420424,5,3,10,46,4258428,21,29,4.0,15,0.517241379,1,3.668055556,61.911,94.46666667,8,71.42857142857143,6
1572,5420124,7,3,22,27,5291187,20,41,3.0,8,0.19512195100000002,1,2.011111111,30.118000000000002,95.75,21,40.0,12
1573,5420087,4,3,17,50,5335437,16,22,4.428571429,12,0.545454545,1,3.4013888889999997,59.891000000000005,116.41666670000001,6,75.0,4
1574,5420084,7,3,17,17,5174978,12,31,4.75,9,0.290322581,1,2.178888889,41.843999999999994,110.2222222,19,75.0,3
1575,5420049,5,3,14,27,3637656,39,65,4.833333333,31,0.47692307700000003,1,8.194444444,175.137,119.2580645,26,79.48717948717949,8
1576,5420044,5,3,13,17,5263354,24,35,4.714285714,16,0.457142857,1,5.913333333,91.115,125.8125,11,66.66666666666666,8
1577,5420042,5,3,15,32,4766531,21,27,4.75,14,0.518518519,1,3.733611111,66.813,106.6428571,6,66.66666666666666,7
1578,5419971,5,3,20,16,5176747,16,25,4.25,15,0.6,1,3.405,65.44,101.8666667,9,93.75,1
1579,5418049,5,3,20,31,5034006,30,56,4.875,13,0.23214285699999998,1,2.454166667,45.027,88.07692308,26,43.333333333333336,17
1580,5416768,6,3,17,49,4459903,16,117,5.0,9,0.076923077,1,1.911944444,28.971,85.11111111,101,56.25,7
1581,5415842,5,3,5,59,4406045,26,111,4.875,20,0.18018018,1,6.435833333,129.274,130.2,85,76.92307692307693,6
1582,5413131,6,3,16,37,4320002,15,66,4.5,4,0.060606060999999996,1,0.789444444,27.296,131.0,51,26.666666666666668,11
1583,5412687,6,3,18,29,5255314,15,31,4.75,10,0.322580645,1,2.309444444,42.248999999999995,98.8,16,66.66666666666666,5
1584,5412402,4,3,20,39,4031725,4,164,5.0,2,0.012195122,1,0.454444444,11.995999999999999,131.0,160,50.0,2
1585,5412376,7,3,12,9,4345771,13,214,5.0,1,0.0046728970000000005,0,0.180833333,4.2989999999999995,94.0,201,7.6923076923076925,12
1586,5412094,3,3,17,24,3844581,16,31,4.714285714,8,0.258064516,1,1.503888889,32.65,93.0,15,50.0,8
1587,5411509,3,3,20,2,4791955,9,20,4.75,9,0.45,1,2.046944444,39.35,102.88888890000001,11,100.0,0
1588,5410438,4,3,18,20,4364405,20,114,4.0,11,0.09649122800000001,1,2.6238888890000003,42.333999999999996,90.45454545,94,55.00000000000001,9
1589,5406151,5,3,16,35,4640364,38,60,4.75,32,0.533333333,1,7.84,155.649,109.15625,22,84.21052631578947,6
1590,5405565,5,3,18,25,3286149,8,13,3.0,8,0.615384615,1,1.613611111,26.953000000000003,82.625,5,100.0,0
1591,5405551,4,3,16,40,4852704,32,43,4.583333333,27,0.627906977,1,9.559444444,135.88299999999998,124.1111111,11,84.375,5
1592,5405172,5,3,6,39,3931772,8,37,4.0,4,0.10810810800000001,1,0.6980555559999999,19.335,107.75,29,50.0,4
1593,5404322,3,3,19,22,5189018,8,28,4.307563701,3,0.107142857,1,1.150277778,15.96,110.66666670000001,20,37.5,5
1594,5404193,3,3,13,30,4988080,20,40,4.5,15,0.375,1,5.661111111,54.919,88.33333333,20,75.0,5
1595,5403686,3,3,15,21,5377139,7,130,4.0,1,0.007692308,0,0.001388889,0.157,45.0,123,14.285714285714285,6
1596,5403269,4,3,19,26,5421106,5,14,5.0,5,0.35714285700000004,1,2.813333333,25.668000000000003,112.4,9,100.0,0
1597,5399982,3,3,20,17,4536716,19,38,4.4,13,0.342105263,1,7.4875,72.773,122.3076923,19,68.42105263157895,6
1598,5398076,4,3,11,56,4925337,65,170,4.0,8,0.047058824000000006,1,2.081111111,29.769000000000002,88.375,105,12.307692307692308,57
1599,5396809,3,3,7,10,4442945,34,103,4.571428571,17,0.165048544,1,4.702777778,78.12899999999999,99.23529412,69,50.0,17
1600,5396280,3,3,19,35,4280939,8,31,4.666666667,8,0.258064516,1,2.8080555560000002,42.521,113.375,23,100.0,0
1601,5396245,5,3,16,28,4867051,5,9,4.333333333,5,0.5555555560000001,1,1.446111111,24.287,101.6,4,100.0,0
1602,5395367,2,3,18,13,5241617,12,32,4.6,10,0.3125,1,2.524722222,39.616,91.4,20,83.33333333333334,2
1603,5395210,3,3,20,38,5101441,34,68,4.538461538,28,0.41176470600000004,1,7.505833332999999,129.31,103.9642857,34,82.35294117647058,6
1604,5394614,3,3,10,15,4572825,8,13,2.5,5,0.384615385,1,0.125277778,6.112,55.6,5,62.5,3
1605,5394137,7,3,17,10,5168411,20,31,5.0,20,0.64516129,1,6.223333332999999,112.259,114.65,11,100.0,0
1606,5390548,5,3,12,38,4752784,19,109,4.428571429,11,0.100917431,1,2.493611111,47.248000000000005,98.72727273,90,57.89473684210527,8
1607,5389387,6,3,16,26,5152261,22,47,4.375,15,0.319148936,1,2.275,43.489,78.53333333,25,68.18181818181817,7
1608,5387680,7,3,21,47,3770238,7,12,4.5,4,0.333333333,1,1.2861111109999999,26.930999999999997,137.5,5,57.14285714285714,3
1609,5386980,4,3,15,4,4124791,9,57,4.0,6,0.10526315800000001,1,1.342222222,23.113000000000003,92.66666667,48,66.66666666666666,3
1610,5384160,1,3,10,9,5368910,5,34,4.307563701,2,0.058823529000000006,1,0.40083333299999996,5.992000000000001,79.0,29,40.0,3
1611,5383415,3,3,11,15,5247578,12,28,3.166666667,11,0.39285714299999996,1,2.1325,37.229,91.63636364,16,91.66666666666666,1
1612,5383214,4,3,10,43,4875771,11,40,4.333333333,8,0.2,1,6.410555556,57.652,137.25,29,72.72727272727273,3
1613,5383040,4,3,14,57,4518841,13,54,4.666666667,8,0.148148148,1,2.130833333,42.583999999999996,115.0,41,61.53846153846154,5
1614,5378355,5,3,10,2,4459348,22,71,4.125,16,0.22535211300000002,1,4.775277778,79.415,106.5625,49,72.72727272727273,6
1615,5375330,5,3,11,7,5424904,7,23,4.75,7,0.304347826,1,1.7291666669999999,28.886999999999997,114.8571429,16,100.0,0
1616,5374380,2,3,11,56,5074748,19,33,4.833333333,11,0.333333333,1,2.898611111,62.955,115.54545449999999,14,57.89473684210527,8
1617,5374060,5,3,9,1,5152140,15,25,4.0,12,0.48,1,2.148055556,43.99,89.16666667,10,80.0,3
1618,5374047,1,3,16,10,3979123,3,11,5.0,1,0.090909091,0,0.247222222,3.563,83.0,8,33.33333333333333,2
1619,5373555,2,3,10,35,3235737,16,25,4.375,14,0.56,1,4.199444444,71.47800000000001,109.7142857,9,87.5,2
1620,5373517,3,3,12,15,5345870,4,33,4.5,4,0.12121212099999999,1,0.955833333,18.062,97.75,29,100.0,0
1621,5369108,4,3,14,9,3480337,8,14,3.333333333,7,0.5,1,1.5116666669999999,24.58,82.28571429,6,87.5,1
1622,5368427,5,3,14,39,4153315,24,44,4.714285714,15,0.340909091,1,4.599722222,73.344,106.26666670000002,20,62.5,9
1623,5368319,5,3,12,57,4560847,8,17,4.0,8,0.470588235,1,1.905277778,26.168000000000003,79.0,9,100.0,0
1624,5368087,4,3,20,42,5337737,7,102,3.0,6,0.058823529000000006,1,1.440833333,25.829,101.5,95,85.71428571428571,1
1625,5368029,2,3,16,36,3407206,38,85,4.3571428569999995,27,0.317647059,1,7.1102777779999995,136.69,106.66666670000001,47,71.05263157894737,11
1626,5362325,4,3,13,46,3782706,7,25,4.0,1,0.04,1,0.471388889,8.42,156.0,18,14.285714285714285,6
1627,5362324,4,3,9,8,4787589,22,59,3.5,8,0.13559322,1,1.859444444,35.746,102.5,37,36.36363636363637,14
1628,5362310,2,3,22,17,4342314,3,12,4.307563701,3,0.25,1,1.0888888890000001,16.275,126.0,9,100.0,0
1629,5362254,4,3,17,36,3889104,5,116,4.0,2,0.017241378999999998,1,0.310555556,6.405,86.0,111,40.0,3
1630,5361067,1,3,9,59,3854792,24,30,4.625,19,0.6333333329999999,1,4.096944444,57.537,77.0,6,79.16666666666666,5
1631,5361031,2,3,15,48,4089959,41,101,4.083333333,25,0.247524752,1,4.337222222,89.834,84.92,60,60.97560975609756,16
1632,5360766,2,3,16,23,4619205,25,50,4.5,17,0.34,1,3.3388888889999997,57.86,83.23529412,25,68.0,8
1633,5358979,5,3,16,38,5339224,4,19,4.5,2,0.10526315800000001,1,0.452222222,8.236,97.0,15,50.0,2
1634,5357548,1,3,12,48,5393243,16,31,4.6,14,0.45161290299999995,1,3.371388889,57.228,93.5,15,87.5,2
1635,5356159,1,3,15,25,3490350,23,141,2.857142857,12,0.08510638300000001,1,4.1425,55.785,103.33333329999999,118,52.17391304347826,11
1636,5355288,2,3,13,27,4212169,29,31,3.5,5,0.161290323,1,1.708888889,27.752,113.6,2,17.24137931034483,24
1637,5354588,4,3,9,58,4985643,20,64,3.8,10,0.15625,1,4.403055556,62.843,128.0,44,50.0,10
1638,5354521,1,3,18,30,4684415,45,103,4.0,22,0.21359223300000002,1,6.089444444,103.74700000000001,100.7727273,58,48.888888888888886,23
1639,5354168,3,3,9,54,5148373,49,90,3.588235294,25,0.27777777800000003,1,7.353333332999999,132.25,110.12,41,51.02040816326531,24
1640,5354106,1,3,10,5,3782716,16,53,4.6,10,0.188679245,1,2.068611111,40.848,93.1,37,62.5,6
1641,5352912,4,3,15,46,4047764,11,29,4.428571429,9,0.310344828,1,2.601666667,41.156000000000006,101.11111109999999,18,81.81818181818183,2
1642,5352797,7,3,19,34,4735237,20,31,4.333333333,12,0.387096774,1,3.5044444439999998,57.926,105.25,11,60.0,8
1643,5348951,4,3,18,1,3730936,12,12,4.2,9,0.75,1,2.0275,29.753,83.0,0,75.0,3
1644,5348574,7,3,13,23,3967972,40,45,4.294117647,31,0.688888889,1,5.505833332999999,112.57799999999999,86.25806452,5,77.5,9
1645,5347771,4,3,18,11,4481980,17,31,3.857142857,15,0.48387096799999996,1,0.891111111,17.764,61.53333333,14,88.23529411764706,2
1646,5347429,2,3,13,35,4706867,14,30,5.0,5,0.166666667,1,1.145555556,20.083,94.6,16,35.714285714285715,9
1647,5346880,3,3,14,5,5410975,5,23,5.0,4,0.17391304300000002,1,1.724166667,27.28,131.75,18,80.0,1
1648,5346278,4,3,13,51,5254344,19,72,4.555555556,14,0.194444444,1,3.971666667,57.31399999999999,95.28571429,53,73.68421052631578,5
1649,5346201,1,3,12,46,4989274,7,17,4.333333333,6,0.352941176,1,2.4986111109999998,41.891000000000005,145.83333330000002,10,85.71428571428571,1
1650,5339851,5,3,18,54,4264054,9,15,4.0,5,0.333333333,1,1.161666667,22.779,101.6,6,55.55555555555556,4
1651,5339190,2,3,13,22,5379980,19,34,4.571428571,14,0.41176470600000004,1,3.502222222,58.617,98.64285714,15,73.68421052631578,5
1652,5333378,2,3,12,22,3275114,15,31,5.0,6,0.193548387,1,1.7908333330000001,30.320999999999998,114.0,16,40.0,9
1653,5333274,2,3,11,10,5161336,6,114,4.5,2,0.01754386,1,0.380833333,5.979,80.0,108,33.33333333333333,4
1654,5332937,4,3,22,32,4672640,22,46,3.9,17,0.36956521700000006,1,5.002222221999999,91.55799999999999,118.5882353,24,77.27272727272727,5
1655,5332522,4,3,17,10,3070821,24,75,3.666666667,18,0.24,1,4.129722222,71.25399999999999,92.77777778,51,75.0,6
1656,5331953,3,3,15,12,5125408,32,36,4.416666667,20,0.5555555560000001,1,5.631111111,89.866,97.85,4,62.5,12
1657,5326523,1,3,15,46,5258973,35,52,4.4,22,0.423076923,1,6.441944444,75.816,84.68181818,17,62.857142857142854,13
1658,5325641,2,3,13,53,5051178,25,55,4.5,23,0.418181818,1,6.07,100.07700000000001,99.86956522,30,92.0,2
1659,5325056,7,3,18,50,4077271,35,82,4.3,29,0.35365853700000005,1,6.218611111,92.26799999999999,81.51724138,47,82.85714285714286,6
1660,5325055,1,3,13,17,3581057,11,43,2.5,7,0.162790698,1,1.5583333330000002,33.739000000000004,106.1428571,32,63.63636363636363,4
1661,5320299,2,3,12,17,3511352,31,58,4.666666667,18,0.310344828,1,4.796944444,84.993,104.66666670000001,27,58.06451612903226,13
1662,5318877,7,3,5,58,4125066,31,127,4.3636363639999995,21,0.165354331,1,4.222222222,82.92399999999999,89.47619048,96,67.74193548387096,10
1663,5318395,3,3,9,22,3564727,19,85,4.125,12,0.141176471,1,3.294444444,64.857,114.83333329999999,66,63.1578947368421,7
1664,5318180,4,3,18,21,5164118,10,12,4.333333333,4,0.333333333,1,1.415,17.015,111.25,2,40.0,6
1665,5316614,6,3,19,0,4552322,24,73,3.777777778,14,0.191780822,1,4.470833333,94.60799999999999,137.71428569999998,49,58.333333333333336,10
1666,5312492,5,3,16,17,4840753,16,24,4.666666667,11,0.45833333299999995,1,2.649722222,52.839,102.5454545,8,68.75,5
1667,5312109,3,3,17,58,5133958,12,32,5.0,6,0.1875,1,0.979166667,23.118000000000002,88.66666667,20,50.0,6
1668,5309101,3,3,23,23,4358719,15,18,4.0,12,0.666666667,1,2.633055556,57.11,111.58333329999999,3,80.0,3
1669,5305072,6,3,11,9,4575021,24,59,4.7,14,0.237288136,1,4.631666667,60.911,103.1428571,35,58.333333333333336,10
1670,5304683,1,3,9,3,3078512,8,101,4.333333333,6,0.059405941,1,1.129444444,16.703,72.16666667,93,75.0,2
1671,5304003,1,3,9,46,4725888,13,33,3.75,6,0.181818182,1,0.133611111,3.867,48.5,20,46.15384615384615,7
1672,5303101,3,3,10,3,3509398,14,44,4.285714286,11,0.25,1,1.01,25.671,68.72727273,30,78.57142857142857,3
1673,5302294,2,3,5,16,3715321,14,23,4.0,8,0.347826087,1,0.019722222,5.484,53.0,9,57.14285714285714,6
1674,5297412,7,3,20,34,4664694,5,43,4.0,4,0.093023256,1,1.185277778,26.394000000000002,126.0,38,80.0,1
1675,5297055,4,3,17,55,3489192,7,15,3.5,5,0.333333333,1,1.6575,24.125999999999998,105.6,8,71.42857142857143,2
1676,5296903,2,3,9,14,4126272,32,102,3.5,9,0.088235294,1,3.102222222,59.869,134.77777780000002,70,28.125,23
1677,5296506,3,3,14,29,4631685,31,36,4.45,25,0.694444444,1,7.410277777999999,110.566,99.04,5,80.64516129032258,6
1678,5296437,2,3,12,24,3043750,23,24,4.5,15,0.625,1,4.313055556,74.64399999999999,109.93333329999999,1,65.21739130434783,8
1679,5295810,1,3,9,30,4734151,32,62,3.9,25,0.403225806,1,0.7261111109999999,45.887,65.24,30,78.125,7
1680,5295742,7,3,16,1,4039225,5,96,3.0,4,0.041666667000000004,1,0.875833333,21.791,111.75,91,80.0,1
1681,5291911,1,3,17,55,3779863,30,51,4.4,23,0.450980392,1,6.794166667000001,123.84299999999999,113.3913043,21,76.66666666666667,7
1682,5289981,4,3,11,41,4178540,16,25,4.666666667,12,0.48,1,3.689166667,54.513999999999996,108.91666670000001,9,75.0,4
1683,5288212,1,3,9,26,4149150,29,65,3.785714286,26,0.4,1,4.7758333330000005,90.87899999999999,83.30769231,36,89.65517241379311,3
1684,5287308,2,3,18,55,3064046,17,21,4.75,11,0.523809524,1,2.515,38.59,84.54545455,4,64.70588235294117,6
1685,5286640,5,3,8,43,4894063,29,46,4.583333333,24,0.52173913,1,5.800833333,105.23899999999999,98.41666667,17,82.75862068965517,5
1686,5277578,1,3,20,30,5224647,21,108,4.0,7,0.064814815,1,1.393611111,25.589000000000002,87.85714286,87,33.33333333333333,14
1687,5273458,1,3,10,39,3069501,36,56,5.0,26,0.46428571399999996,1,6.127777778,92.65799999999999,84.26923077,20,72.22222222222221,10
1688,5273325,4,3,20,41,3888324,13,18,5.0,9,0.5,1,1.647777778,30.565,93.0,5,69.23076923076923,4
1689,5272566,7,3,12,10,4801099,6,29,5.0,4,0.137931034,1,0.167222222,1.651,47.5,23,66.66666666666666,2
1690,5266354,5,3,8,28,5105438,35,151,4.5,17,0.11258278099999999,1,3.669166667,66.43,96.58823529,116,48.57142857142857,18
1691,5266018,3,3,19,41,5191713,14,62,5.0,8,0.129032258,1,0.779444444,18.434,69.0,48,57.14285714285714,6
1692,5265446,2,3,10,24,4906647,26,218,3.5,10,0.04587156,1,3.037222222,58.515,119.8,192,38.46153846153847,16
1693,5264442,6,3,17,45,5391284,8,78,5.0,4,0.051282050999999995,1,0.896111111,20.262,111.0,70,50.0,4
1694,5262720,3,3,12,36,5128547,8,56,3.0,3,0.053571429000000004,1,0.9730555559999999,17.798,118.33333329999999,48,37.5,5
1695,5256255,1,3,12,51,4238510,30,48,4.5,19,0.39583333299999995,1,7.088888889,106.932,116.5263158,18,63.33333333333333,11
1696,5256251,1,3,15,59,4823360,14,75,5.0,7,0.093333333,1,2.218055556,24.924,84.42857143,61,50.0,7
1697,5255600,6,3,7,35,3112913,25,39,4.454545455,19,0.487179487,1,6.033888889,101.098,118.8947368,14,76.0,6
1698,5252600,5,3,17,39,4300746,3,27,4.5,3,0.111111111,1,0.0058333330000000004,0.405,45.0,24,100.0,0
1699,5249585,7,3,16,19,4584594,26,57,4.375,19,0.333333333,1,4.642777778,84.54,100.52631579999999,31,73.07692307692307,7
1700,5247866,2,3,9,28,5286718,22,45,4.666666667,10,0.222222222,1,3.494166667,59.919,121.2,23,45.45454545454545,12
1701,5244767,7,3,9,26,4331323,17,24,4.5,13,0.541666667,1,2.574166667,56.145,95.46153846,7,76.47058823529412,4
1702,5237322,1,3,13,26,4928651,20,40,4.5,4,0.1,0,0.2625,3.935,55.0,20,20.0,16
1703,5230208,5,3,16,22,4687126,12,96,4.0,6,0.0625,1,0.6886111109999999,15.334000000000001,74.0,84,50.0,6
1704,5228005,7,3,12,38,5006389,5,49,5.0,3,0.06122449,1,1.0927777779999999,18.041,126.33333329999999,44,60.0,2
1705,5226367,5,3,20,15,4889806,37,92,4.416666667,31,0.33695652200000004,1,10.38583333,151.143,106.32258059999998,55,83.78378378378379,6
1706,5225227,2,3,7,45,5294078,15,30,4.25,6,0.2,1,1.4638888890000001,23.71,82.0,15,40.0,9
1707,5224595,1,3,13,2,5385484,26,98,3.333333333,12,0.12244898,1,3.202222222,51.338,96.5,72,46.15384615384615,14
1708,5219932,1,3,9,13,5029237,25,90,3.428571429,15,0.166666667,1,4.592222222,96.15700000000001,128.2666667,65,60.0,10
1709,5219909,2,3,10,21,5402287,50,86,4.1,24,0.27906976699999997,1,8.3525,98.82,96.58333333,36,48.0,26
1710,5219811,1,3,7,58,5337988,12,28,4.0,9,0.321428571,1,2.9869444439999997,51.548,116.55555559999999,16,75.0,3
1711,5219143,2,3,16,0,5310354,7,58,5.0,3,0.051724137999999996,1,0.8683333329999999,21.151,135.66666669999998,51,42.857142857142854,4
1712,5217975,4,3,14,9,3766792,29,37,4.375,18,0.486486486,1,4.948333333,89.61399999999999,107.5,8,62.06896551724138,11
1713,5217632,2,3,17,3,5405412,22,66,4.714285714,13,0.196969697,1,4.6672222219999995,84.508,128.5384615,44,59.09090909090909,9
1714,5217312,1,3,22,38,4866439,32,89,4.5,19,0.213483146,1,3.793333333,72.374,90.68421053,57,59.375,13
1715,5213425,5,3,18,23,5207877,9,65,4.5,5,0.076923077,1,0.42972222200000004,12.54,73.6,56,55.55555555555556,4
1716,5213337,7,3,11,47,5149182,5,18,1.5,5,0.27777777800000003,1,1.9033333330000002,30.35,125.0,13,100.0,0
1717,5212631,2,3,11,44,4194705,24,53,3.714285714,14,0.264150943,1,1.9266666669999999,42.261,83.57142857,29,58.333333333333336,10
1718,5212014,2,3,5,26,4748894,8,107,3.666666667,7,0.065420561,1,1.055833333,23.099,97.71428571,99,87.5,1
1719,5211874,3,3,11,2,5278313,15,47,3.5,12,0.25531914899999997,1,2.6913888889999997,55.761,99.25,32,80.0,3
1720,5207399,3,3,7,45,5062654,21,66,4.666666667,10,0.151515152,1,1.928055556,39.023,96.2,45,47.61904761904761,11
1721,5206263,2,3,13,20,4573595,32,48,4.3,29,0.604166667,1,6.078333333,107.36399999999999,87.79310345,16,90.625,3
1722,5206116,1,3,13,34,5208588,16,39,4.0,11,0.282051282,1,3.4955555560000002,50.11600000000001,100.81818179999999,23,68.75,5
1723,5205403,3,3,21,19,3088623,13,25,3.5,10,0.4,1,1.925555556,35.186,91.1,12,76.92307692307693,3
1724,5205188,2,3,10,45,4933477,31,93,4.75,18,0.193548387,1,5.261111111,77.39399999999999,95.88888889,62,58.06451612903226,13
1725,5204770,1,3,10,46,4798289,20,29,4.0,10,0.344827586,1,2.423055556,43.887,102.2,9,50.0,10
1726,5202619,1,3,11,22,4511455,57,228,4.0,39,0.17105263199999998,1,11.46972222,199.165,109.2307692,171,68.42105263157895,18
1727,5198118,2,3,18,9,4293296,11,24,4.0,8,0.333333333,1,1.7983333330000002,36.999,102.25,13,72.72727272727273,3
1728,5179669,2,3,13,50,4393712,18,24,3.25,12,0.5,1,1.645277778,30.46,69.75,6,66.66666666666666,6
1729,5179341,2,3,10,48,4467730,7,74,3.0,3,0.040540541,1,0.742222222,10.913,87.66666667,67,42.857142857142854,4
1730,5179321,4,3,15,4,5300529,22,46,4.375,15,0.326086957,1,3.295833333,57.076,89.06666667,24,68.18181818181817,7
1731,5178892,7,3,12,14,4538221,7,26,4.666666667,4,0.153846154,1,1.012777778,18.832,102.75,19,57.14285714285714,3
1732,5178673,1,3,14,30,5382036,44,57,4.294117647,36,0.6315789470000001,1,9.838611111,161.606,100.08333329999999,13,81.81818181818183,8
1733,5174281,5,3,9,17,5368516,20,29,4.545454545,16,0.551724138,1,3.659166667,67.85600000000001,97.1875,9,80.0,4
1734,5169841,5,3,19,7,4731099,29,75,4.0,7,0.093333333,1,0.729166667,20.267,81.71428571,46,24.137931034482758,22
1735,5159604,4,3,20,9,5421854,38,53,4.777777778,22,0.41509434,1,6.274444443999999,108.863,109.2727273,15,57.89473684210527,16
1736,5159557,2,3,15,26,5170334,7,41,3.0,5,0.12195122,1,1.5263888890000001,25.325,106.0,34,71.42857142857143,2
1737,5146462,7,3,18,15,4684122,12,56,4.0,3,0.053571429000000004,1,1.186388889,18.559,123.0,44,25.0,9
1738,5142034,4,3,21,3,3949686,19,30,3.666666667,9,0.3,1,3.213611111,52.916000000000004,124.2222222,11,47.368421052631575,10
1739,5138785,3,3,16,7,4139285,17,114,4.0,4,0.035087718999999996,1,1.309722222,22.186,111.25,97,23.52941176470588,13
1740,5138606,1,3,9,49,4603680,16,73,3.0,10,0.136986301,1,3.139722222,59.463,126.7,57,62.5,6
1741,5138434,2,3,11,40,3736417,11,15,4.25,10,0.666666667,1,2.705833333,52.636,110.7,4,90.9090909090909,1
1742,5137826,7,3,17,28,5333720,10,47,4.4,8,0.17021276600000002,1,1.880555556,28.91,88.375,37,80.0,2
1743,5131417,2,3,19,3,4885261,27,36,4.0,24,0.666666667,1,6.500555556,106.79899999999999,98.875,9,88.88888888888889,3
1744,5131367,5,3,17,47,3670556,32,35,4.466666667,24,0.685714286,1,8.696944444,123.196,110.70833329999999,3,75.0,8
1745,5129731,1,3,19,16,4575021,6,16,5.0,4,0.25,1,1.7752777780000002,22.125999999999998,113.25,10,66.66666666666666,2
1746,5125750,5,3,19,26,3086784,20,36,3.538461538,16,0.444444444,1,3.285,66.403,99.625,16,80.0,4
1747,5121546,7,3,15,25,3846908,26,48,4.7,20,0.41666666700000005,1,5.33,103.176,108.25,22,76.92307692307693,6
1748,5117191,3,3,6,38,3670044,17,27,4.0,8,0.296296296,1,2.605833333,52.236000000000004,130.0,10,47.05882352941176,9
1749,5116272,2,3,10,19,4884720,41,51,4.263157895,37,0.725490196,1,10.19333333,169.36900000000003,101.27027029999999,10,90.2439024390244,4
1750,5116244,3,3,18,12,3348082,8,32,4.4,7,0.21875,1,2.584444444,35.341,111.1428571,24,87.5,1
1751,5115402,2,3,15,46,5217288,33,49,4.166666667,14,0.28571428600000004,1,4.3552777780000005,67.188,102.6428571,16,42.42424242424242,19
1752,5113451,3,3,17,21,5404274,22,42,4.625,16,0.380952381,1,5.004444444,84.26899999999999,113.4375,20,72.72727272727273,6
1753,5113238,5,3,8,36,5106853,3,29,4.5,2,0.068965517,1,1.3186111109999998,18.902,174.5,26,66.66666666666666,1
1754,5106465,7,3,13,21,5273920,6,56,5.0,5,0.089285714,1,1.372222222,18.67,90.6,50,83.33333333333334,1
1755,5106296,5,3,18,49,4628807,34,72,4.181818182,24,0.333333333,1,4.360277778,95.699,92.33333333,38,70.58823529411765,10
1756,5105648,7,3,16,8,4587715,21,53,4.272727273,20,0.377358491,1,6.153055556,114.354,118.6,32,95.23809523809523,1
1757,5105116,2,3,15,32,4919602,24,58,4.272727273,21,0.362068966,1,6.6213888889999994,113.82799999999999,114.4761905,34,87.5,3
1758,5105108,7,3,9,0,5429633,15,38,4.307563701,10,0.263157895,1,0.480555556,24.553,72.6,23,66.66666666666666,5
1759,5084143,2,3,19,6,5344098,20,51,5.0,9,0.176470588,1,1.8141666669999998,40.176,103.7777778,31,45.0,11
1760,5083974,3,3,12,21,4363138,21,27,4.6,12,0.444444444,1,3.575,50.776,98.41666667,6,57.14285714285714,9
1761,5074355,3,3,9,29,4754511,17,52,4.0,6,0.115384615,1,1.559166667,22.513,93.83333333,35,35.294117647058826,11
1762,5068041,1,3,9,36,5377035,18,89,4.5,7,0.078651685,1,0.855833333,15.507,66.42857143,71,38.88888888888889,11
1763,5068016,2,3,13,34,4395866,29,69,4.0,26,0.37681159399999997,1,5.817777778,112.68299999999999,101.42307690000001,40,89.65517241379311,3
1764,5066380,2,3,13,27,5263354,10,125,5.0,4,0.032,1,0.78,9.969,67.5,115,40.0,6
1765,5062239,1,3,20,12,5397498,17,30,4.1428571430000005,14,0.46666666700000003,1,5.739166667,87.417,122.5,13,82.35294117647058,3
1766,5060554,7,3,18,12,3520975,57,90,4.233333333,43,0.477777778,1,9.490555556,186.762,96.58139535,33,75.43859649122807,14
1767,5059034,7,3,19,22,5421238,29,71,4.75,12,0.169014085,1,2.062222222,41.17100000000001,83.91666667,42,41.37931034482759,17
1768,5053969,1,3,15,40,4723508,19,46,4.1428571430000005,12,0.260869565,1,2.9280555560000003,44.878,89.91666667,27,63.1578947368421,7
1769,5053068,3,3,10,18,4058662,53,87,4.133333333,29,0.333333333,1,7.170277777999999,103.836,86.65517241,34,54.71698113207547,24
1770,5052362,4,3,9,19,3968973,6,11,5.0,4,0.363636364,1,1.247222222,22.112,111.75,5,66.66666666666666,2
1771,5050122,2,3,21,25,4587176,31,66,4.0,27,0.409090909,1,3.561666667,65.027,72.77777778,35,87.09677419354838,4
1772,5035533,3,3,18,51,4343908,35,58,3.666666667,29,0.5,1,7.850555556000001,136.531,108.44827590000001,23,82.85714285714286,6
1773,5034028,2,3,16,28,5258808,14,77,3.666666667,8,0.103896104,1,3.5322222219999997,58.788000000000004,143.125,63,57.14285714285714,6
1774,5026532,1,3,17,56,4892504,20,44,4.5,4,0.090909091,1,0.003333333,4.982,59.0,24,20.0,16
1775,5025629,1,3,12,49,4846283,9,24,4.4,6,0.25,1,2.3447222219999997,40.285,131.5,15,66.66666666666666,3
1776,5023765,5,3,7,42,4868794,9,12,4.2,6,0.5,1,1.4227777780000002,27.063000000000002,104.66666670000001,3,66.66666666666666,3
1777,5020187,3,3,16,49,5281534,15,21,4.285714286,15,0.7142857140000001,1,3.3258333330000003,59.348,91.86666667,6,100.0,0
1778,5019033,3,3,21,37,4910616,38,52,4.583333333,24,0.46153846200000004,1,3.9680555560000004,111.844,108.66666670000001,14,63.1578947368421,14
1779,5018906,6,3,13,36,5175713,22,42,4.8888888889999995,18,0.428571429,1,5.809722222,107.969,125.2777778,20,81.81818181818183,4
1780,5018239,6,3,9,1,3839554,15,80,4.0,3,0.0375,1,0.688888889,15.668,120.66666670000001,65,20.0,12
1781,5017023,1,3,17,57,4542883,14,25,4.25,8,0.32,1,2.747777778,52.771,134.125,11,57.14285714285714,6
1782,5005686,1,3,18,55,4595547,7,65,4.0,5,0.076923077,1,1.2802777779999999,19.41,89.6,58,71.42857142857143,2
1783,5005633,2,3,10,39,5400244,31,55,4.0,19,0.345454545,1,6.3433333329999995,113.365,122.5263158,24,61.29032258064516,12
1784,5004196,2,3,16,56,3417802,6,13,3.75,4,0.307692308,1,1.450277778,19.766,104.75,7,66.66666666666666,2
1785,5003937,7,3,15,38,4849913,20,34,4.666666667,8,0.235294118,1,2.099166667,39.065,107.5,14,40.0,12
1786,5003911,3,3,19,6,4726522,7,9,5.0,6,0.666666667,1,1.4830555559999998,18.894000000000002,77.16666667,2,85.71428571428571,1
1787,4996619,5,3,13,20,4529244,26,71,4.75,15,0.21126760600000002,1,4.6525,67.54,100.9333333,45,57.692307692307686,11
1788,4986192,5,3,8,30,4132313,13,21,4.428571429,12,0.571428571,1,2.8658333330000003,53.578,97.66666667,8,92.3076923076923,1
1789,4986153,4,3,18,22,4610076,5,16,4.0,3,0.1875,1,0.895277778,16.955,129.6666667,11,60.0,2
1790,4984302,2,3,11,43,4321045,16,18,4.333333333,12,0.666666667,1,4.3875,61.657,111.91666670000001,2,75.0,4
1791,4980025,2,3,6,37,4888283,14,97,4.0,6,0.06185567,1,0.653611111,21.123,90.33333333,83,42.857142857142854,8
1792,4965815,2,3,10,20,5374926,33,50,4.25,23,0.46,1,5.733055556,96.96,94.21739129999999,17,69.6969696969697,10
1793,4964244,3,3,13,21,4275097,8,40,4.5,6,0.15,1,0.9680555559999999,12.183,64.0,32,75.0,2
1794,4962525,5,3,19,25,5195158,6,41,5.0,3,0.073170732,1,1.208333333,9.742,80.33333333,35,50.0,3
1795,4959090,1,3,18,29,3516832,35,52,4.769230769,24,0.46153846200000004,1,6.931111111,115.67399999999999,104.66666670000001,17,68.57142857142857,11
1796,4954019,5,3,19,31,3614667,10,87,4.2,7,0.08045977,1,1.9416666669999998,33.671,109.1428571,77,70.0,3
1797,4951561,2,3,12,38,5129855,18,18,4.333333333,13,0.7222222220000001,1,3.461666667,56.887,98.23076923,0,72.22222222222221,5
1798,4944474,3,3,18,23,3616566,10,52,3.5,7,0.134615385,1,1.169722222,19.079,75.14285714,42,70.0,3
1799,4940237,3,3,17,24,4933880,20,48,4.1428571430000005,15,0.3125,1,4.16,73.318,107.53333329999998,28,75.0,5
1800,4932777,2,3,11,37,4408011,14,88,4.0,11,0.125,1,2.5533333330000003,54.78,107.2727273,74,78.57142857142857,3
1801,4932018,4,3,15,27,4757981,8,41,4.666666667,3,0.073170732,1,0.705555556,12.637,92.0,33,37.5,5
1802,4919604,1,3,15,45,5323162,25,46,4.272727273,21,0.456521739,1,3.4911111110000004,54.196999999999996,70.0,21,84.0,4
1803,4916483,5,3,21,27,4502941,20,47,4.75,13,0.276595745,1,2.588611111,55.43600000000001,103.1538462,27,65.0,7
1804,4915632,5,3,8,46,5333171,5,75,4.666666667,5,0.066666667,1,1.5516666669999999,26.838,112.6,70,100.0,0
1805,4914950,1,3,20,22,4328243,10,24,5.0,9,0.375,1,2.419722222,35.9,92.11111111,14,90.0,1
1806,4910065,1,3,12,12,5229655,16,72,4.75,13,0.180555556,1,2.621666667,41.133,81.76923077,56,81.25,3
1807,4899706,2,3,16,53,4923512,28,35,4.5,25,0.7142857140000001,1,6.4405555560000005,119.846,104.4,7,89.28571428571429,3
1808,4893298,2,3,9,47,5034218,40,58,4.307563701,1,0.017241378999999998,1,0.33555555600000003,6.6979999999999995,142.0,18,2.5,39
1809,4881514,1,3,16,37,4359082,31,64,4.5,16,0.25,1,4.051666667,74.517,101.9375,33,51.61290322580645,15
1810,4880792,1,3,12,53,5333807,23,67,4.8571428569999995,13,0.194029851,1,2.8244444439999996,47.163000000000004,86.46153846,44,56.52173913043478,10
1811,4875703,5,3,14,52,4044136,21,39,4.5,15,0.384615385,1,5.225277778,88.086,118.93333329999999,18,71.42857142857143,6
1812,4874975,1,3,18,55,4942078,39,83,3.8,14,0.16867469899999998,1,4.176388889,68.90899999999999,105.1428571,44,35.8974358974359,25
1813,4870120,1,3,18,32,5398417,25,74,4.666666667,12,0.162162162,1,3.2980555560000004,63.424,116.83333329999999,49,48.0,13
1814,4867776,2,3,13,31,5403156,20,74,3.5,9,0.121621622,1,2.106111111,34.784,92.11111111,54,45.0,11
1815,4862247,2,3,7,34,4693823,16,57,4.0,5,0.087719298,1,0.16777777800000002,4.994,51.4,41,31.25,11
1816,4852745,2,3,19,36,4725900,9,22,4.0,7,0.318181818,1,2.943055556,51.853,141.8571429,13,77.77777777777779,2
1817,4833627,6,3,20,46,3812164,19,29,3.888888889,16,0.551724138,1,23.37583333,69.645,99.4375,10,84.21052631578947,3
1818,4825882,2,3,9,48,5306861,23,26,4.666666667,22,0.846153846,1,4.682777778,67.48899999999999,77.0,3,95.65217391304348,1
1819,4818253,2,3,10,27,4467730,11,76,4.0,5,0.065789474,1,1.257777778,18.239,84.8,65,45.45454545454545,6
1820,4810060,5,3,9,50,5001679,14,45,4.0,9,0.2,1,3.0961111110000004,46.973,117.66666670000001,31,64.28571428571429,5
1821,4809311,1,3,19,14,3660150,9,70,5.0,4,0.057142857000000005,1,1.046944444,19.075,102.25,61,44.44444444444444,5
1822,4797969,2,3,8,57,5036808,3,21,5.0,2,0.095238095,1,0.571944444,9.494,107.0,18,66.66666666666666,1
1823,4785715,2,3,16,8,3789441,30,38,3.9,23,0.605263158,1,6.7325,141.965,126.0,8,76.66666666666667,7
1824,4778792,5,3,16,14,5306070,23,62,2.8,9,0.14516129,1,5.123333333,70.65,149.22222219999998,39,39.130434782608695,14
1825,4773361,1,3,11,15,4129045,14,81,4.4,9,0.111111111,1,1.955555556,31.489,83.66666667,67,64.28571428571429,5
1826,4770413,1,3,11,36,5039302,13,72,4.8,8,0.111111111,1,2.051944444,43.216,111.75,59,61.53846153846154,5
1827,4765923,4,3,8,47,4792765,22,45,4.4,16,0.355555556,1,0.7019444440000001,16.239,55.5625,23,72.72727272727273,6
1828,4761114,2,3,19,8,5267491,19,34,4.0,17,0.5,1,4.615277778,78.0,104.0,15,89.47368421052632,2
1829,4758376,7,3,16,59,4889666,9,35,2.0,3,0.085714286,1,0.491944444,23.344,146.66666669999998,26,33.33333333333333,6
1830,4754146,3,3,20,14,5239814,8,25,5.0,3,0.12,1,0.7544444440000001,12.458,92.33333333,17,37.5,5
1831,4744267,5,3,10,42,4553161,4,6,5.0,2,0.333333333,1,0.5327777779999999,12.42,123.0,2,50.0,2
1832,4741675,2,3,16,56,3963740,21,33,4.571428571,12,0.363636364,1,1.799166667,30.811999999999998,73.5,12,57.14285714285714,9
1833,4740834,2,3,16,54,3484498,12,61,4.307563701,2,0.032786885,1,0.41444444399999997,9.679,104.5,49,16.666666666666664,10
1834,4736704,2,3,12,35,4682012,18,100,4.0,11,0.11,1,2.748611111,43.085,92.45454545,82,61.111111111111114,7
1835,4719048,2,3,12,59,5383493,23,30,4.0,16,0.533333333,1,3.140277778,48.778999999999996,83.125,7,69.56521739130434,7
1836,4715668,5,3,10,57,4568402,17,49,4.333333333,12,0.244897959,1,2.644444444,48.183,90.25,32,70.58823529411765,5
1837,4712745,7,3,12,41,4600935,7,54,5.0,3,0.055555556,1,1.096111111,23.885,147.66666669999998,47,42.857142857142854,4
1838,4711220,4,3,14,34,4940817,12,43,4.2,8,0.186046512,1,2.778333333,34.024,96.875,31,66.66666666666666,4
1839,4709638,3,3,7,18,4944639,13,42,4.666666667,8,0.19047619,1,1.532777778,40.626,106.25,29,61.53846153846154,5
1840,4705148,2,3,14,17,4493087,14,111,4.5,5,0.045045045,1,1.5083333330000002,20.677,92.0,97,35.714285714285715,9
1841,4700650,4,3,17,13,5330049,12,28,4.666666667,8,0.28571428600000004,1,1.815,35.876999999999995,101.125,16,66.66666666666666,4
1842,4696214,3,3,21,8,3198342,8,24,3.4,7,0.291666667,1,1.1711111109999999,24.56,89.14285714,16,87.5,1
1843,4691019,2,3,16,39,5346994,16,26,4.285714286,15,0.576923077,1,3.479722222,71.12,107.6,10,93.75,1
1844,4679303,6,3,4,12,3063118,4,5,5.0,1,0.2,0,0.637222222,2.513,73.0,1,25.0,3
1845,4673855,5,3,15,19,4797573,14,42,4.25,7,0.166666667,1,2.395277778,46.217,131.4285714,28,50.0,7
1846,4658714,1,3,20,3,5065735,9,25,4.5,7,0.28,1,1.934722222,32.52,97.71428571,16,77.77777777777779,2
1847,4658403,2,3,21,18,3875612,10,25,4.8,9,0.36,1,1.5783333330000002,34.87,96.44444444,15,90.0,1
1848,4657629,3,3,0,53,4928504,15,36,4.75,11,0.305555556,1,1.709444444,40.824,117.9090909,21,73.33333333333333,4
1849,4657071,5,3,10,39,4780368,15,87,4.2,10,0.114942529,1,2.246666667,36.775,87.6,72,66.66666666666666,5
1850,4653134,2,3,17,17,5161300,7,21,2.5,5,0.23809523800000001,1,1.149166667,20.195999999999998,92.6,14,71.42857142857143,2
1851,4649481,1,3,13,35,4542608,22,88,4.25,13,0.14772727300000002,1,4.117777778,76.742,120.07692309999999,66,59.09090909090909,9
1852,4648386,2,3,18,21,5397523,9,36,5.0,6,0.166666667,1,2.746944444,45.365,145.16666669999998,27,66.66666666666666,3
1853,4637864,2,3,13,40,4726853,27,45,4.6,18,0.4,1,3.773055556,81.578,98.5,18,66.66666666666666,9
1854,4633181,1,3,10,17,5344986,31,67,4.333333333,10,0.149253731,1,2.272222222,43.048,99.8,36,32.25806451612903,21
1855,4625503,1,3,10,14,4677915,21,104,4.625,15,0.144230769,1,4.391944444,81.122,113.06666670000001,83,71.42857142857143,6
1856,4613832,1,3,10,30,4628387,25,51,4.285714286,16,0.31372549,1,4.4025,82.845,107.875,26,64.0,9
1857,4612889,2,3,21,25,4420035,14,37,3.0,11,0.297297297,1,2.281944444,38.475,89.81818182,23,78.57142857142857,3
1858,4604445,1,3,9,46,4250545,5,5,4.0,1,0.2,1,0.384722222,6.599,157.0,0,20.0,4
1859,4603124,1,3,22,2,4243104,18,24,4.3,12,0.5,1,2.478333333,52.51,112.66666670000001,6,66.66666666666666,6
1860,4599428,3,3,14,33,5015284,15,42,4.75,12,0.28571428600000004,1,3.574166667,84.166,140.5,27,80.0,3
1861,4598089,3,3,16,11,5317129,8,25,4.5,7,0.28,1,2.2075,36.357,106.42857140000001,17,87.5,1
1862,4581156,5,3,9,51,4687126,59,102,4.1363636360000005,42,0.41176470600000004,1,12.40722222,203.951,106.42857140000001,43,71.1864406779661,17
1863,4578297,2,3,13,20,3266040,8,248,4.307563701,1,0.0040322579999999995,0,0.23972222199999998,3.8489999999999998,88.0,240,12.5,7
1864,4572797,5,3,17,44,5372516,10,27,4.0,6,0.222222222,1,2.773333333,32.593,119.5,17,60.0,4
1865,4559491,2,3,19,18,5406690,21,45,4.428571429,13,0.288888889,1,2.856111111,57.38399999999999,97.38461538,24,61.904761904761905,8
1866,4558413,1,3,6,55,4858142,6,11,5.0,5,0.454545455,1,1.01,19.587,92.4,5,83.33333333333334,1
1867,4554267,5,3,10,10,4455665,25,29,4.909090909,24,0.8275862070000001,1,7.586944443999999,121.103,109.66666670000001,4,96.0,1
1868,4546226,7,3,15,11,4961050,10,47,3.666666667,5,0.106382979,1,1.136666667,23.128,103.8,37,50.0,5
1869,4532374,1,3,15,1,4042513,42,82,4.1428571430000005,27,0.329268293,1,8.355,150.172,115.44444440000001,40,64.28571428571429,15
1870,4531224,4,3,18,10,4105079,4,20,4.5,3,0.15,1,0.629166667,11.232000000000001,88.66666667,16,75.0,1
1871,4524411,3,3,12,53,4604755,49,102,3.75,5,0.049019608,1,1.885,32.226,128.6,53,10.204081632653061,44
1872,4516334,2,3,11,21,3085302,12,60,5.0,6,0.1,1,1.856111111,31.176,109.66666670000001,48,50.0,6
1873,4511903,5,3,10,13,3999292,7,41,4.0,4,0.097560976,1,1.4316666669999998,20.31,106.0,34,57.14285714285714,3
1874,4498319,5,3,15,4,4954659,12,26,3.333333333,8,0.307692308,1,2.219166667,44.702,120.875,14,66.66666666666666,4
1875,4473248,7,3,22,9,4861095,8,16,4.0,5,0.3125,1,0.46166666700000003,12.207,78.4,8,62.5,3
1876,4431252,7,3,21,21,4555895,8,22,4.0,6,0.272727273,1,1.710277778,31.184,110.33333329999999,14,75.0,2
1877,4425346,1,3,13,22,4838879,20,31,4.4,20,0.64516129,1,4.775277778,86.87200000000001,97.2,11,100.0,0
1878,4421190,1,3,10,16,3548827,5,12,4.75,5,0.41666666700000005,1,1.135555556,22.834,99.4,7,100.0,0
1879,4416219,4,3,14,28,4563932,14,42,4.2,12,0.28571428600000004,1,3.787777778,58.29600000000001,105.58333329999999,28,85.71428571428571,2
1880,4414940,1,3,10,56,4790154,28,133,4.444444444,17,0.127819549,1,3.8894444439999996,50.133,78.47058824,105,60.71428571428571,11
1881,4408305,2,3,17,52,4761366,37,58,4.4,14,0.24137931,1,5.569166667,74.2,115.57142859999999,21,37.83783783783784,23
1882,4391741,7,3,13,53,3919516,11,23,4.5,10,0.434782609,1,3.3658333330000003,58.358000000000004,118.7,12,90.9090909090909,1
1883,4373417,4,3,20,14,5145389,16,33,5.0,12,0.363636364,1,3.097777778,72.71600000000001,127.83333329999999,17,75.0,4
1884,4372708,3,3,19,6,5341834,18,26,4.428571429,10,0.384615385,1,1.4705555559999999,24.072,72.8,8,55.55555555555556,8
1885,4367430,5,3,13,49,5212093,36,83,4.4,17,0.204819277,1,4.119166667,69.271,94.52941176,47,47.22222222222222,19
1886,4366452,1,3,12,53,5379984,9,17,4.4,6,0.352941176,1,2.158888889,38.645,127.16666670000001,8,66.66666666666666,3
1887,4358221,3,3,6,34,5190957,15,24,4.5,7,0.291666667,1,1.5,25.031,84.85714286,9,46.666666666666664,8
1888,4357418,4,3,8,50,4555213,3,32,4.307563701,2,0.0625,1,0.304166667,9.119,98.5,29,66.66666666666666,1
1889,4348842,5,3,17,39,5265571,4,33,4.307563701,2,0.060606060999999996,1,0.854166667,13.047,135.5,29,50.0,2
1890,4331277,1,3,12,4,3890368,9,31,5.0,4,0.129032258,1,0.9,18.426,104.25,22,44.44444444444444,5
1891,4313254,3,3,11,9,3949438,14,30,4.5,11,0.36666666700000006,1,3.0488888889999997,49.821000000000005,99.54545455,16,78.57142857142857,3
1892,4303398,4,3,19,56,5323064,8,10,5.0,7,0.7,1,1.375277778,21.225,81.71428571,2,87.5,1
1893,4299139,2,3,10,18,4391260,3,12,4.307563701,1,0.083333333,0,0.015277778,0.073,45.0,9,33.33333333333333,2
1894,4298705,5,3,21,51,4194042,24,57,4.444444444,15,0.263157895,1,3.4,49.426,83.2,33,62.5,9
1895,4264497,7,3,11,59,4968619,16,32,4.6,9,0.28125,1,3.0263888889999997,52.922,119.55555559999999,16,56.25,7
1896,4263775,6,3,22,10,5054770,37,130,4.307563701,1,0.007692308,1,0.000277778,1.6,54.0,93,2.7027027027027026,36
1897,4253549,3,3,21,16,5176606,23,26,5.0,19,0.7307692309999999,1,6.752777778,117.01100000000001,129.84210530000001,3,82.6086956521739,4
1898,4243699,3,3,21,41,5081587,20,56,4.5,11,0.19642857100000002,1,3.800833333,72.623,133.2727273,36,55.00000000000001,9
1899,4225010,4,3,13,45,5360940,31,36,4.384615385,26,0.7222222220000001,1,8.176944444,128.651,107.11538459999998,5,83.87096774193549,5
1900,4212020,4,3,13,54,4542178,3,5,4.5,3,0.6,1,0.7597222220000001,13.637,105.0,2,100.0,0
1901,4211898,3,3,13,44,3105500,17,55,4.25,12,0.218181818,1,3.183888889,55.41,102.91666670000001,38,70.58823529411765,5
1902,4182411,4,3,17,7,3286260,17,81,3.888888889,14,0.172839506,1,3.505277778,55.473,89.78571429,64,82.35294117647058,3
1903,4174398,2,3,12,33,4862468,28,63,4.714285714,18,0.28571428600000004,1,6.083333333,106.296,123.2222222,35,64.28571428571429,10
1904,4155397,1,3,10,13,3923973,10,31,4.0,6,0.193548387,1,1.8366666669999998,27.361,98.33333333,21,60.0,4
1905,4124475,3,3,9,13,4787589,7,49,5.0,3,0.06122449,1,0.720833333,17.635,121.0,42,42.857142857142854,4
1906,4122033,5,3,16,10,3801536,35,73,4.307692308,20,0.273972603,1,4.626944443999999,70.661,85.55,38,57.14285714285714,15
1907,4111955,4,3,14,8,5334770,8,160,4.307563701,2,0.0125,1,0.5558333329999999,2.464,55.5,152,25.0,6
1908,4095262,4,3,17,46,3665422,9,25,4.6,7,0.28,1,1.871388889,35.431999999999995,108.2857143,16,77.77777777777779,2
1909,4076078,2,3,10,48,5126802,20,22,4.666666667,17,0.772727273,1,4.819722222,92.245,111.5294118,2,85.0,3
1910,4060767,2,3,6,5,3758763,8,42,4.0,4,0.095238095,1,0.424444444,9.465,66.75,34,50.0,4
1911,4040262,2,3,13,18,4714239,31,54,4.214285714,26,0.481481481,1,8.258055556,129.274,106.6538462,23,83.87096774193549,5
1912,4038846,4,3,15,21,5138930,3,11,4.307563701,1,0.090909091,1,0.313611111,5.817,117.0,8,33.33333333333333,2
1913,4004354,4,3,18,20,4577428,33,75,4.076923077,23,0.306666667,1,6.6736111110000005,94.49,95.95652174,42,69.6969696969697,10
1914,3998369,3,3,11,51,5410621,25,32,4.1428571430000005,13,0.40625,1,2.725277778,40.787,78.07692308,7,52.0,12
1915,3996627,7,3,13,38,4048998,6,11,1.5,4,0.363636364,1,1.323055556,19.139,103.25,5,66.66666666666666,2
1916,3990972,4,3,9,16,4663544,6,76,4.0,2,0.026315789,1,0.7019444440000001,14.059000000000001,135.5,70,33.33333333333333,4
1917,3990952,5,3,15,24,4147119,35,46,4.375,33,0.7173913040000001,1,8.065277777999999,147.685,100.4848485,11,94.28571428571428,2
1918,3978052,1,3,11,48,4116467,8,116,4.0,6,0.051724137999999996,1,1.362777778,24.478,95.83333333,108,75.0,2
1919,3969754,5,3,8,54,4559922,30,77,4.0,20,0.25974026,1,4.783888889,77.968,91.7,47,66.66666666666666,10
1920,3961063,1,3,16,52,5115214,33,53,4.4,6,0.11320754699999999,1,2.066666667,33.055,111.66666670000001,20,18.181818181818183,27
1921,3956036,4,3,18,7,3366418,10,14,4.6,8,0.571428571,1,2.081388889,33.997,95.875,4,80.0,2
1922,3945768,3,3,21,7,3520883,25,47,4.666666667,16,0.34042553200000003,1,5.8786111110000006,97.70100000000001,122.625,22,64.0,9
1923,3918252,2,3,6,21,4535569,19,72,4.25,15,0.208333333,1,4.0033333330000005,69.943,105.2,53,78.94736842105263,4
1924,3891107,2,3,16,57,4265466,14,17,4.5,9,0.529411765,1,2.745277778,39.191,96.11111111,3,64.28571428571429,5
1925,3878003,2,3,13,34,3046568,68,104,4.466666667,34,0.326923077,1,6.1502777779999995,118.863,85.5,36,50.0,34
1926,3870107,1,3,14,39,3513320,24,39,4.4,16,0.41025641,1,3.715277778,56.068999999999996,85.3125,15,66.66666666666666,8
1927,3868092,1,3,11,45,5189444,47,106,4.653846154,39,0.367924528,1,9.986388889,157.053,91.8974359,59,82.97872340425532,8
1928,3838939,2,3,17,23,4372939,13,20,4.571428571,11,0.55,1,2.597222222,50.528,102.81818179999999,7,84.61538461538461,2
1929,3834479,4,3,17,17,3985734,14,15,4.5,9,0.6,1,2.581111111,36.927,93.77777778,1,64.28571428571429,5
1930,3832925,2,3,12,40,5172067,43,57,4.533333333,28,0.49122807,1,5.645,100.331,86.07142857,14,65.11627906976744,15
1931,3820852,1,3,11,11,5033215,13,93,5.0,4,0.043010753,1,1.105,15.693,88.75,80,30.76923076923077,9
1932,3813743,4,3,17,32,4147787,18,33,4.0,11,0.333333333,1,2.764166667,47.755,98.81818182,15,61.111111111111114,7
1933,3801331,1,3,11,14,4598123,12,25,5.0,6,0.24,1,2.1475,39.063,128.0,13,50.0,6
1934,3758181,3,3,16,48,3864806,28,48,4.285714286,16,0.333333333,1,4.969166667,74.191,102.75,20,57.14285714285714,12
1935,3744385,2,3,11,53,4254336,8,33,3.0,3,0.090909091,1,0.953333333,16.998,113.66666670000001,25,37.5,5
1936,3718226,1,3,21,44,4113902,44,67,4.3684210530000005,36,0.537313433,1,10.49277778,179.275,106.30555559999999,23,81.81818181818183,8
1937,3708560,1,3,7,15,4677850,7,10,5.0,1,0.1,1,0.24611111100000002,5.635,115.0,3,14.285714285714285,6
1938,3698085,5,3,6,21,4459348,9,57,3.0,5,0.087719298,1,0.591944444,19.717,94.2,48,55.55555555555556,4
1939,3670561,2,3,18,20,4862931,15,65,4.666666667,9,0.138461538,1,2.746388889,36.562,91.22222222,50,60.0,6
1940,3646787,5,3,15,22,3993614,13,76,4.5,10,0.131578947,1,3.4305555560000003,59.586999999999996,128.6,63,76.92307692307693,3
1941,3636342,3,3,14,0,4045382,43,80,4.166666667,24,0.3,1,8.258333333,122.088,109.29166670000001,37,55.81395348837209,19
1942,3633295,7,3,12,54,5241617,16,21,4.75,12,0.571428571,1,3.5086111110000004,56.478,102.33333329999999,5,75.0,4
1943,3620819,3,3,11,10,4914427,32,67,4.5,23,0.34328358200000003,1,7.239722222,100.05,96.56521739,35,71.875,9
1944,3598539,5,3,15,0,5109957,31,35,4.538461538,25,0.7142857140000001,1,6.586388889,130.268,113.2,4,80.64516129032258,6
1945,3520711,5,3,22,30,4714537,7,61,4.307563701,1,0.016393443,1,0.1675,5.155,116.0,54,14.285714285714285,6
1946,3501304,4,3,15,6,4874274,25,34,4.461538462,21,0.6176470589999999,1,5.898333332999999,103.456,109.3809524,9,84.0,4
1947,3448655,3,3,14,36,5355421,19,53,4.8,10,0.188679245,1,4.647222222,71.092,135.9,34,52.63157894736842,9
1948,3446102,4,3,17,22,5384864,11,48,3.8,10,0.208333333,1,0.383888889,15.341,64.6,37,90.9090909090909,1
1949,3437386,5,3,12,13,3511973,4,30,4.307563701,2,0.066666667,1,0.6625,5.4,73.0,26,50.0,2
1950,3434940,2,3,14,53,4328943,41,80,4.0,19,0.2375,1,3.546111111,66.22,89.36842105,39,46.34146341463415,22
1951,3399348,2,3,21,14,4808711,13,69,4.307563701,1,0.014492753999999998,1,0.073888889,1.714,61.0,56,7.6923076923076925,12
1952,3393179,4,3,20,37,4931277,25,25,4.3571428569999995,24,0.96,1,6.183333332999999,115.113,106.375,0,96.0,1
1953,3379506,2,3,12,24,3591266,39,97,4.0,28,0.28865979399999997,1,6.7361111110000005,123.586,96.57142857,58,71.7948717948718,11
1954,3362531,3,3,18,54,5240517,10,19,4.0,8,0.42105263200000004,1,1.626111111,33.235,92.875,9,80.0,2
1955,3353278,2,3,9,1,5043433,6,91,5.0,2,0.021978022000000003,1,0.576666667,13.16,129.0,85,33.33333333333333,4
1956,3231684,5,3,19,19,4876178,14,26,4.0,3,0.115384615,1,2.1741666669999997,12.574000000000002,97.66666667,12,21.428571428571427,11
1957,3203592,2,3,9,30,4628840,3,91,4.0,3,0.032967033,1,0.8613888890000001,17.475,121.66666670000001,88,100.0,0
1958,3174762,7,3,14,1,5413805,7,30,4.0,2,0.066666667,1,0.365,5.875,78.5,23,28.57142857142857,5
1959,3109035,5,3,18,40,5158418,10,83,5.0,2,0.024096386,1,0.327777778,4.876,74.0,73,20.0,8
1960,3072522,3,3,12,34,5358213,11,55,5.0,3,0.054545455,1,0.855555556,12.492,98.66666667,44,27.27272727272727,8
1961,3067864,2,3,13,30,4992889,6,25,4.666666667,4,0.16,1,1.3780555559999998,18.236,100.0,19,66.66666666666666,2
1962,3058127,1,3,22,17,4823360,7,14,3.0,5,0.35714285700000004,1,0.910833333,15.09,86.4,7,71.42857142857143,2
1963,2991424,2,3,12,57,3866788,3,11,4.5,3,0.272727273,1,1.242222222,19.840999999999998,129.3333333,8,100.0,0
1964,2955357,1,3,10,33,4497322,15,38,4.333333333,9,0.236842105,1,2.873333333,50.403,117.44444440000001,23,60.0,6
1965,2950334,4,3,14,15,5277631,13,82,4.5,13,0.158536585,1,2.323055556,38.67,77.69230769,69,100.0,0
1966,2932747,3,3,9,4,4640375,9,51,4.307563701,5,0.098039216,1,0.848888889,20.963,93.8,42,55.55555555555556,4
1967,2931334,6,3,12,58,5422937,5,17,5.0,4,0.235294118,1,1.2469444440000002,27.070999999999998,135.5,12,80.0,1
1968,2922157,2,3,14,24,5387672,13,26,4.5,3,0.115384615,1,1.184166667,15.933,117.0,13,23.076923076923077,10
1969,5434379,6,2,19,16,3839617,24,39,4.5,19,0.487179487,1,1.7669444440000002,47.836999999999996,75.89473684,15,79.16666666666666,5
1970,5427223,7,2,9,2,3506821,20,21,3.625,9,0.428571429,1,2.8511111110000003,45.45399999999999,109.44444440000001,1,45.0,11
1971,5427134,7,2,9,6,3066075,6,8,4.333333333,4,0.5,1,1.175,20.79,108.0,2,66.66666666666666,2
1972,5426762,6,2,11,46,3923904,14,22,4.666666667,12,0.545454545,1,2.959722222,48.247,95.33333333,8,85.71428571428571,2
1973,5426172,7,2,15,12,4862649,22,83,4.333333333,11,0.13253012,1,4.1425,73.062,135.4545455,61,50.0,11
1974,5426147,6,2,17,3,3761195,8,20,3.333333333,7,0.35,1,0.6361111110000001,15.850999999999999,75.57142857,12,87.5,1
1975,5425389,5,2,15,38,5195782,10,13,3.666666667,9,0.692307692,1,1.876388889,31.846,88.44444444,3,90.0,1
1976,5425369,7,2,10,21,3760828,6,8,5.0,6,0.75,1,1.232777778,25.191999999999997,94.16666667,2,100.0,0
1977,5425348,5,2,16,9,4812269,8,45,4.0,4,0.088888889,1,0.361944444,7.647,68.25,37,50.0,4
1978,5424527,7,2,11,45,4093787,17,22,4.0,12,0.545454545,1,3.0916666669999997,64.521,113.91666670000001,5,70.58823529411765,5
1979,5420063,5,2,11,23,4959819,6,16,4.307563701,4,0.25,1,1.3733333330000002,9.359,71.75,10,66.66666666666666,2
1980,5420018,6,2,10,42,5416799,11,30,4.307563701,6,0.2,1,2.8638888889999996,49.536,161.33333330000002,19,54.54545454545454,5
1981,5419982,6,2,11,56,5192386,15,34,3.666666667,7,0.20588235300000002,1,1.5555555559999998,24.385,87.57142857,19,46.666666666666664,8
1982,5419274,7,2,19,7,5186230,9,13,4.8,6,0.46153846200000004,1,1.7047222219999998,49.369,155.83333330000002,4,66.66666666666666,3
1983,5419085,5,2,17,1,3612560,34,83,4.294117647,29,0.34939759,1,8.416111111000001,141.281,110.41379309999999,49,85.29411764705883,5
1984,5419058,5,2,9,8,4640219,10,72,4.333333333,6,0.083333333,1,1.559722222,25.927,105.16666670000001,62,60.0,4
1985,5417964,5,2,14,41,5078173,21,25,4.0,19,0.76,1,5.7977777779999995,84.162,96.57894737,4,90.47619047619048,2
1986,5417584,5,2,15,27,4048925,6,41,4.25,5,0.12195122,1,0.5475,12.992,72.6,35,83.33333333333334,1
1987,5412639,7,2,19,38,5109532,7,21,4.307563701,2,0.095238095,1,0.513333333,11.038,113.0,14,28.57142857142857,5
1988,5412532,5,2,12,59,3982778,30,53,4.333333333,18,0.33962264200000003,1,4.499722222,73.346,96.55555556,23,60.0,12
1989,5412081,6,2,19,34,3047758,6,42,4.5,4,0.095238095,1,1.2469444440000002,19.085,109.0,36,66.66666666666666,2
1990,5411534,5,2,8,25,5261199,10,20,4.0,9,0.45,1,2.095555556,36.101,92.66666667,10,90.0,1
1991,5411200,4,2,13,55,3850789,14,16,3.8,9,0.5625,1,2.336666667,36.756,93.66666667,2,64.28571428571429,5
1992,5407531,7,2,16,58,4848967,6,42,4.666666667,4,0.095238095,1,0.610555556,11.482000000000001,75.75,36,66.66666666666666,2
1993,5406508,7,2,14,26,4232633,13,32,4.5,10,0.3125,1,2.218333333,46.205,100.3,19,76.92307692307693,3
1994,5405937,3,2,17,30,5036983,5,71,4.307563701,2,0.028169014,1,0.548888889,5.412000000000001,82.5,66,40.0,3
1995,5405042,4,2,15,18,3826443,3,5,4.0,2,0.4,1,0.8480555559999999,14.889000000000001,144.0,2,66.66666666666666,1
1996,5404270,3,2,9,39,5163636,4,100,4.307563701,3,0.03,0,0.023611111,3.72,58.66666667,96,75.0,1
1997,5402387,4,2,9,47,3627784,4,10,4.307563701,1,0.1,1,0.11388888900000001,2.653,77.0,6,25.0,3
1998,5399293,7,2,15,18,5298622,14,69,5.0,11,0.15942029,1,2.665,61.07899999999999,119.18181820000001,55,78.57142857142857,3
1999,5397342,6,2,13,52,5227924,20,47,4.2,16,0.34042553200000003,1,6.3725,86.61399999999999,119.0625,27,80.0,4
2000,5396493,4,2,17,2,4754557,18,28,4.0,13,0.46428571399999996,1,3.6719444439999998,60.233000000000004,103.1538462,10,72.22222222222221,5
2001,5396076,6,2,13,49,5432420,5,28,4.307563701,1,0.035714286,1,0.000277778,4.405,106.0,23,20.0,4
2002,5395778,3,2,12,11,5367260,21,35,4.0,15,0.428571429,1,3.119722222,63.839,95.6,14,71.42857142857143,6
2003,5395400,3,2,16,57,3071129,5,19,4.666666667,5,0.263157895,1,0.502222222,11.432,71.0,14,100.0,0
2004,5394298,5,2,16,41,5079369,11,17,4.8,8,0.470588235,1,1.726111111,37.113,104.375,6,72.72727272727273,3
2005,5388717,7,2,18,1,5050270,12,27,4.0,9,0.333333333,1,2.136388889,45.004,105.2222222,15,75.0,3
2006,5388518,1,2,6,31,3536817,7,7,5.0,6,0.857142857,1,2.511111111,32.411,111.83333329999999,0,85.71428571428571,1
2007,5387848,1,2,10,2,4773359,5,11,4.5,2,0.181818182,1,0.517777778,8.573,92.0,6,40.0,3
2008,5382023,5,2,12,10,3870956,15,29,4.0,11,0.379310345,1,2.785,42.794,92.45454545,14,73.33333333333333,4
2009,5381347,4,2,14,13,4498335,5,13,4.75,4,0.307692308,1,0.532222222,13.276,81.5,8,80.0,1
2010,5376011,1,2,17,51,4603732,6,10,4.5,4,0.4,1,1.211666667,18.511,98.0,4,66.66666666666666,2
2011,5375761,3,2,7,36,4005498,7,13,4.333333333,5,0.384615385,1,1.0686111109999998,21.701999999999998,95.6,6,71.42857142857143,2
2012,5374398,1,2,20,59,4716039,22,32,4.0,16,0.5,1,4.103888888999999,80.444,115.3125,10,72.72727272727273,6
2013,5374353,3,2,11,38,4484106,20,37,4.4,10,0.27027027,1,2.7630555560000003,58.523,120.6,17,50.0,10
2014,5373542,2,2,16,35,5302907,10,21,4.333333333,9,0.428571429,1,2.7230555560000003,44.632,108.0,11,90.0,1
2015,5370107,7,2,20,49,4272890,12,48,4.0,4,0.083333333,1,0.456111111,10.952,77.25,36,33.33333333333333,8
2016,5368958,3,2,13,3,3755860,4,16,5.0,2,0.125,1,0.7222222220000001,11.115,113.0,12,50.0,2
2017,5368718,2,2,15,9,5309858,5,16,5.0,4,0.25,1,1.415277778,21.037,110.25,11,80.0,1
2018,5367916,1,2,18,44,4508670,22,34,4.571428571,13,0.382352941,1,3.2402777780000003,58.097,98.84615385,12,59.09090909090909,9
2019,5367780,2,2,13,37,5338304,8,20,4.666666667,8,0.4,1,2.4677777780000003,41.898999999999994,108.75,12,100.0,0
2020,5367779,1,2,12,31,4781582,17,43,4.5,10,0.23255814,1,3.062222222,45.532,97.7,26,58.82352941176471,7
2021,5366752,3,2,17,7,4124068,4,15,3.0,2,0.133333333,1,1.215833333,13.799000000000001,138.5,11,50.0,2
2022,5366589,7,2,19,6,4623953,2,24,4.0,2,0.083333333,1,0.596666667,13.708,129.5,22,100.0,0
2023,5365337,2,2,8,22,4448530,11,28,4.0,9,0.321428571,1,3.225277778,26.374000000000002,80.77777778,17,81.81818181818183,2
2024,5363655,5,2,15,16,4292496,7,101,4.8,7,0.069306931,1,1.9127777780000002,26.747,90.14285714,94,100.0,0
2025,5362731,7,2,11,4,4958095,12,26,4.5,9,0.346153846,1,2.236111111,47.769,110.44444440000001,14,75.0,3
2026,5361513,3,2,18,58,4868544,2,32,4.307563701,1,0.03125,1,0.680555556,11.875,212.0,30,50.0,1
2027,5361472,1,2,15,56,3689008,5,17,4.5,5,0.294117647,1,1.9266666669999999,34.246,132.8,12,100.0,0
2028,5360551,1,2,9,27,4537984,19,40,4.428571429,13,0.325,1,4.7869444439999995,67.04,109.5384615,21,68.42105263157895,6
2029,5360532,4,2,21,56,4202044,2,9,4.307563701,2,0.222222222,1,0.36166666700000005,7.995,97.0,7,100.0,0
2030,5359727,1,2,15,49,5397034,13,23,4.714285714,12,0.52173913,1,3.6516666669999998,58.497,103.16666670000001,10,92.3076923076923,1
2031,5357051,2,2,10,58,5042072,11,76,4.0,9,0.11842105300000001,1,2.874166667,57.761,132.4444444,65,81.81818181818183,2
2032,5355571,2,2,12,34,3984973,4,12,4.5,4,0.333333333,1,1.195833333,15.942,93.5,8,100.0,0
2033,5355559,2,2,18,53,3085713,6,41,5.0,5,0.12195122,1,0.772222222,19.935,97.6,35,83.33333333333334,1
2034,5355071,3,2,10,20,4899397,6,12,4.0,4,0.333333333,1,0.593888889,12.044,84.75,6,66.66666666666666,2
2035,5354626,2,2,18,20,4633896,9,14,4.2,7,0.5,1,3.266388889,53.397,144.1428571,5,77.77777777777779,2
2036,5354597,1,2,12,18,5205197,57,95,4.416666667,25,0.263157895,1,6.688333332999999,119.384,104.16,38,43.859649122807014,32
2037,5354510,4,2,18,8,5021685,4,26,3.0,3,0.115384615,1,0.8141666670000001,13.265,101.0,22,75.0,1
2038,5354277,3,2,18,51,3105479,43,58,4.285714286,26,0.448275862,1,7.892222222000001,132.47899999999998,112.5,15,60.46511627906976,17
2039,5348292,4,2,8,37,4280939,8,155,4.307563701,3,0.019354839,1,0.730833333,12.263,105.33333329999999,147,37.5,5
2040,5341174,1,2,10,25,4761024,4,20,4.307563701,2,0.1,1,0.553888889,7.115,86.5,16,50.0,2
2041,5340249,3,2,9,45,4687126,5,39,4.0,1,0.025641026,1,0.205833333,2.862,78.0,34,20.0,4
2042,5340221,1,2,18,6,3574388,8,8,4.8,7,0.875,1,1.9675,23.951,81.0,0,87.5,1
2043,5339195,4,2,9,35,5023578,6,20,4.307563701,2,0.1,1,0.365,12.804,132.5,14,33.33333333333333,4
2044,5334090,4,2,17,53,5247192,4,41,4.307563701,1,0.024390244,1,0.199444444,1.999,60.0,37,25.0,3
2045,5332856,3,2,16,48,5364519,10,18,2.5,6,0.333333333,1,2.273333333,38.56,132.5,8,60.0,4
2046,5332470,1,2,10,24,4856508,8,49,3.0,5,0.10204081599999999,1,0.885277778,13.562000000000001,71.2,41,62.5,3
2047,5332151,2,2,19,36,3811508,20,40,3.25,8,0.2,1,1.644166667,37.86,106.625,20,40.0,12
2048,5332146,5,2,11,23,4043311,11,24,5.0,8,0.333333333,1,2.429444444,32.845,94.5,13,72.72727272727273,3
2049,5329150,1,2,11,54,5014399,15,18,4.0,13,0.7222222220000001,1,4.260833333,64.818,106.0,3,86.66666666666667,2
2050,5325123,2,2,17,13,4701953,6,30,4.5,5,0.166666667,1,1.2177777779999999,20.01,98.2,24,83.33333333333334,1
2051,5325020,1,2,16,14,4783885,11,32,4.25,9,0.28125,1,2.489444444,41.044,99.66666667,21,81.81818181818183,2
2052,5324405,7,2,20,2,5422626,8,10,5.0,4,0.4,1,0.999166667,21.209,116.75,2,50.0,4
2053,5319719,2,2,18,45,4220153,3,30,4.307563701,1,0.033333333,1,0.000555556,15.974,270.0,27,33.33333333333333,2
2054,5319326,6,2,21,39,5436991,12,26,4.2,12,0.46153846200000004,1,2.081666667,36.806999999999995,82.33333333,14,100.0,0
2055,5319312,3,2,20,48,4693369,12,26,4.0,11,0.423076923,1,3.1752777780000003,55.136,110.81818179999999,14,91.66666666666666,1
2056,5318498,7,2,18,17,5171081,8,39,4.75,7,0.179487179,1,1.4427777780000002,30.304000000000002,95.71428571,31,87.5,1
2057,5311278,3,2,19,28,5411598,5,13,4.666666667,5,0.384615385,1,1.241666667,28.846999999999998,120.8,8,100.0,0
2058,5311253,4,2,19,56,5197393,10,24,4.2,9,0.375,1,2.5527777780000003,47.927,112.33333329999999,14,90.0,1
2059,5310984,1,2,6,29,4637711,4,28,4.307563701,1,0.035714286,0,0.145833333,2.9760000000000004,75.0,24,25.0,3
2060,5310158,3,2,13,39,5367785,14,34,5.0,8,0.235294118,1,4.062222222,60.838,147.125,20,57.14285714285714,6
2061,5309730,1,2,17,36,4904278,39,54,4.333333333,23,0.425925926,1,6.229166667,105.927,100.6956522,15,58.97435897435898,16
2062,5308363,4,2,18,40,5273713,2,19,5.0,2,0.10526315800000001,1,0.18194444399999998,3.397,58.0,17,100.0,0
2063,5305152,1,2,7,19,5336416,20,44,4.0,12,0.272727273,1,3.267222222,62.426,108.25,24,60.0,8
2064,5304161,2,2,9,41,4992182,3,19,4.307563701,2,0.10526315800000001,1,0.48472222200000004,8.924,102.5,16,66.66666666666666,1
2065,5303746,6,2,16,54,5008897,3,33,5.0,1,0.03030303,0,0.010555556,0.184,45.0,30,33.33333333333333,2
2066,5303691,3,2,15,21,3252401,9,98,5.0,1,0.010204082,0,0.178888889,3.013,75.0,89,11.11111111111111,8
2067,5303604,2,2,14,51,4959717,15,23,3.8,9,0.39130434799999997,1,1.5794444440000002,36.028,97.66666667,8,60.0,6
2068,5303130,3,2,16,32,3292433,6,12,4.8,6,0.5,1,1.405277778,16.549,75.83333333,6,100.0,0
2069,5302995,1,2,15,39,4794651,17,24,3.6,11,0.45833333299999995,1,1.25,37.214,85.81818182,7,64.70588235294117,6
2070,5302110,2,2,20,34,5292270,25,44,4.5,19,0.43181818200000005,1,4.994444444,83.48200000000001,97.36842105,19,76.0,6
2071,5302078,7,2,12,26,4575432,13,19,4.6,11,0.578947368,1,2.5869444440000002,53.433,106.2727273,6,84.61538461538461,2
2072,5301387,2,2,5,52,5299283,5,37,5.0,4,0.10810810800000001,1,0.4825,10.116,72.5,32,80.0,1
2073,5297427,2,2,19,23,3104931,16,16,4.0,14,0.875,1,2.794166667,51.629,89.28571429,0,87.5,2
2074,5296815,2,2,21,22,4498648,7,27,5.0,5,0.185185185,1,1.099722222,25.588,110.0,20,71.42857142857143,2
2075,5296602,7,2,12,8,5043709,8,15,4.666666667,8,0.533333333,1,2.4472222219999997,41.198,107.5,7,100.0,0
2076,5296598,7,2,19,39,4525920,3,9,4.307563701,1,0.111111111,0,0.000833333,0.001,45.0,6,33.33333333333333,2
2077,5296473,1,2,9,8,4720147,11,35,4.307563701,4,0.11428571400000001,1,0.768055556,16.792,95.5,24,36.36363636363637,7
2078,5296171,3,2,16,54,5356274,5,12,4.5,5,0.41666666700000005,1,2.053611111,23.278000000000002,100.4,7,100.0,0
2079,5295219,2,2,10,52,3514322,25,98,4.571428571,15,0.153061224,1,5.817222222000001,113.51299999999999,143.8666667,73,60.0,10
2080,5295034,2,2,17,21,5040596,8,57,4.0,3,0.052631579000000005,1,1.3927777780000001,28.041999999999998,167.66666669999998,49,37.5,5
2081,5295024,1,2,7,56,4041052,8,73,5.0,1,0.01369863,1,0.433055556,7.08,136.0,65,12.5,7
2082,5294962,1,2,9,35,4042225,14,80,4.5,5,0.0625,1,1.685555556,26.959,112.0,66,35.714285714285715,9
2083,5293470,5,2,11,3,3326049,7,20,5.0,6,0.3,1,2.085555556,17.52,75.83333333,13,85.71428571428571,1
2084,5291593,1,2,9,54,4757115,9,30,4.333333333,5,0.166666667,1,0.9027777779999999,17.924,83.0,21,55.55555555555556,4
2085,5289626,2,2,10,18,3150829,17,23,4.0,1,0.043478261,0,0.094166667,2.8710000000000004,73.0,6,5.88235294117647,16
2086,5287650,4,2,13,36,5418848,10,79,2.0,6,0.075949367,1,1.178055556,22.503,89.16666667,69,60.0,4
2087,5286942,1,2,19,6,4868993,3,14,4.307563701,2,0.14285714300000002,1,1.293888889,18.313,167.0,11,66.66666666666666,1
2088,5280589,1,2,11,36,5394828,11,14,4.5,8,0.571428571,1,2.609722222,39.268,108.5,3,72.72727272727273,3
2089,5274896,2,2,8,10,4339950,7,14,4.4,6,0.428571429,1,1.915,30.24,113.66666670000001,7,85.71428571428571,1
2090,5273682,7,2,11,43,4542417,22,27,4.272727273,19,0.703703704,1,4.399166667,65.82600000000001,83.63157895,5,86.36363636363636,3
2091,5271207,1,2,10,35,5367053,4,53,4.307563701,1,0.018867925,1,0.28444444399999996,4.821000000000001,113.0,49,25.0,3
2092,5270734,1,2,15,3,3047735,14,21,4.3,13,0.6190476189999999,1,2.99,49.923,90.07692308,7,92.85714285714286,1
2093,5266172,1,2,17,36,4686118,11,25,3.0,8,0.32,1,1.9952777780000002,27.249000000000002,88.25,14,72.72727272727273,3
2094,5265992,2,2,18,39,5216311,5,46,4.0,2,0.043478261,1,0.165833333,3.969,60.0,41,40.0,3
2095,5265493,1,2,16,33,4414294,32,40,4.5882352939999995,29,0.725,1,7.948611111,117.791,93.37931034,8,90.625,3
2096,5265421,2,2,13,3,4347920,3,44,1.0,3,0.06818181799999999,1,1.112222222,22.896,148.0,41,100.0,0
2097,5263080,1,2,22,10,4113942,12,24,2.5,9,0.375,1,4.257222222,27.612,81.66666667,12,75.0,3
2098,5256348,3,2,12,46,4907481,2,10,5.0,1,0.1,0,0.171666667,2.988,75.0,8,50.0,1
2099,5255916,1,2,11,38,4604039,19,45,4.333333333,11,0.24444444399999998,1,2.653611111,49.321000000000005,100.2727273,26,57.89473684210527,8
2100,5254427,7,2,18,30,5389662,6,34,4.5,3,0.088235294,1,1.054444444,12.323,99.0,28,50.0,3
2101,5251626,1,2,10,58,4194981,18,24,4.25,13,0.541666667,1,3.793333333,65.833,108.07692309999999,6,72.22222222222221,5
2102,5251219,2,2,13,42,4197159,3,5,3.333333333,3,0.6,1,0.8786111109999999,14.079,97.66666667,2,100.0,0
2103,5250387,1,2,12,26,4575865,12,15,4.6,11,0.7333333329999999,1,3.413888889,52.461000000000006,103.5454545,3,91.66666666666666,1
2104,5250332,2,2,17,26,5270548,7,20,4.5,5,0.25,1,1.453055556,23.039,107.2,13,71.42857142857143,2
2105,5250124,2,2,8,3,4903637,6,15,4.307563701,3,0.2,1,1.275555556,17.601,118.0,9,50.0,3
2106,5249965,4,2,15,40,5245680,7,65,4.333333333,5,0.076923077,1,1.781944444,13.86,73.4,58,71.42857142857143,2
2107,5248896,7,2,10,33,4040944,2,12,4.5,2,0.166666667,1,0.675555556,13.84,143.5,10,100.0,0
2108,5248798,2,2,12,37,4720258,6,33,5.0,2,0.060606060999999996,1,0.7494444440000001,11.913,123.0,27,33.33333333333333,4
2109,5248796,7,2,20,9,5012923,9,21,4.307563701,5,0.23809523800000001,1,1.415,22.714000000000002,104.6,12,55.55555555555556,4
2110,5248461,4,2,19,41,4491962,5,18,5.0,4,0.222222222,1,1.054166667,19.572,116.0,13,80.0,1
2111,5248216,2,2,10,42,5212649,8,24,4.333333333,5,0.208333333,1,2.863333333,29.037,119.4,16,62.5,3
2112,5247914,1,2,11,14,5173692,8,16,3.8,5,0.3125,1,0.9069444440000001,18.575,87.2,8,62.5,3
2113,5239391,4,2,17,19,5232011,15,22,4.285714286,13,0.590909091,1,3.6763888889999996,71.86399999999999,116.38461540000002,7,86.66666666666667,2
2114,5229386,4,2,20,42,4664031,4,13,5.0,3,0.23076923100000002,1,0.518888889,12.184000000000001,109.33333329999999,9,75.0,1
2115,5227369,3,2,19,11,4827757,21,49,4.666666667,8,0.163265306,1,0.29583333300000003,5.571000000000001,52.5,28,38.095238095238095,13
2116,5227169,7,2,21,11,4895806,5,13,5.0,3,0.23076923100000002,1,0.5708333329999999,12.565999999999999,101.0,8,60.0,2
2117,5226722,1,2,12,54,5165609,6,7,4.307563701,3,0.428571429,1,0.7363888890000001,11.517000000000001,89.33333333,1,50.0,3
2118,5226134,5,2,14,38,3992971,5,34,4.0,4,0.117647059,1,0.676666667,11.857999999999999,76.25,29,80.0,1
2119,5221432,3,2,14,42,4940076,20,21,3.9,18,0.857142857,1,4.443055556,82.59299999999999,100.0,1,90.0,2
2120,5219901,1,2,19,28,4120095,5,48,4.0,4,0.083333333,0,0.001944444,5.555,57.25,43,80.0,1
2121,5219823,2,2,21,16,4218951,11,41,4.333333333,3,0.073170732,0,0.410555556,9.373,87.0,30,27.27272727272727,8
2122,5214953,2,2,12,33,4335190,10,15,4.0,7,0.46666666700000003,1,2.7011111110000003,46.461000000000006,132.1428571,5,70.0,3
2123,5210804,1,2,8,30,5301258,2,16,4.307563701,1,0.0625,1,0.238333333,5.114,107.0,14,50.0,1
2124,5203201,5,2,15,37,5426681,16,89,4.5,6,0.06741573,1,1.384166667,18.56,79.83333333,73,37.5,10
2125,5198325,1,2,14,8,4786523,10,27,5.0,7,0.25925925899999996,1,2.219444444,41.413999999999994,126.8571429,17,70.0,3
2126,5198183,2,2,20,52,5397104,6,23,5.0,4,0.17391304300000002,1,0.29444444399999997,6.7989999999999995,58.25,17,66.66666666666666,2
2127,5197278,1,2,13,54,5396258,12,37,5.0,8,0.21621621600000002,1,1.058888889,14.905,58.0,25,66.66666666666666,4
2128,5188466,7,2,10,50,4242333,3,12,5.0,2,0.166666667,1,0.8058333329999999,19.214000000000002,171.0,9,66.66666666666666,1
2129,5185459,5,2,18,24,3781104,12,20,4.333333333,12,0.6,1,3.165555556,56.428999999999995,107.41666670000001,8,100.0,0
2130,5180196,3,2,5,44,5076203,4,6,5.0,4,0.666666667,1,0.847777778,17.803,101.5,2,100.0,0
2131,5178946,7,2,15,21,3818231,7,13,3.333333333,7,0.538461538,1,1.5475,33.617,101.1428571,6,100.0,0
2132,5176672,6,2,15,25,5335966,3,25,4.307563701,1,0.04,0,0.133333333,2.853,80.0,22,33.33333333333333,2
2133,5174762,1,2,21,50,3490675,33,74,4.0,19,0.256756757,1,7.018333332999999,100.941,112.31578950000001,41,57.57575757575758,14
2134,5174479,1,2,10,21,5010430,12,19,4.5,7,0.36842105299999994,1,2.595555556,37.869,113.1428571,7,58.333333333333336,5
2135,5173690,1,2,20,57,5389849,5,25,4.307563701,4,0.16,1,0.9186111109999999,18.476,99.25,20,80.0,1
2136,5169939,2,2,22,53,5298162,20,26,4.666666667,6,0.23076923100000002,1,1.525555556,39.188,134.33333330000002,6,30.0,14
2137,5169220,5,2,13,43,4833032,13,29,4.0,7,0.24137931,1,1.960833333,45.45399999999999,127.57142859999999,16,53.84615384615385,6
2138,5169103,3,2,19,23,4493605,4,13,4.75,4,0.307692308,1,0.558055556,14.419,84.0,9,100.0,0
2139,5168825,3,2,10,45,4794635,9,77,4.307563701,1,0.012987013,1,0.28305555600000004,6.502999999999999,128.0,68,11.11111111111111,8
2140,5168368,2,2,18,21,3635969,16,30,5.0,9,0.3,1,1.7430555559999998,37.986,95.88888889,14,56.25,7
2141,5166170,3,2,13,14,4483671,7,11,5.0,4,0.363636364,1,1.268611111,21.1,113.5,4,57.14285714285714,3
2142,5166106,2,2,19,37,4405056,6,22,4.0,4,0.181818182,1,0.935,15.870999999999999,89.0,16,66.66666666666666,2
2143,5165223,5,2,10,18,5109532,3,11,4.307563701,2,0.181818182,1,0.137222222,3.9330000000000003,59.5,8,66.66666666666666,1
2144,5165146,4,2,16,51,3609025,3,7,4.5,3,0.428571429,1,3.2830555560000003,24.517,152.33333330000002,4,100.0,0
2145,5160387,1,2,12,15,4698425,6,19,4.307563701,1,0.052631579000000005,1,0.868611111,14.795,256.0,13,16.666666666666664,5
2146,5159581,1,2,12,6,5109154,8,12,4.5,7,0.583333333,1,1.623055556,28.929000000000002,95.85714286,4,87.5,1
2147,5158978,5,2,10,46,5301238,2,15,4.307563701,1,0.066666667,1,0.148055556,2.275,74.0,13,50.0,1
2148,5158791,1,2,15,40,4926008,5,6,4.5,3,0.5,1,0.900833333,13.040999999999999,98.33333333,1,60.0,2
2149,5157551,3,2,9,12,4605221,5,8,4.307563701,1,0.125,1,0.10472222199999999,1.93,59.0,3,20.0,4
2150,5145880,2,2,9,27,5251157,25,44,4.4,12,0.272727273,1,2.628888889,51.537,94.41666667,19,48.0,13
2151,5140244,5,2,13,25,5168959,5,27,4.5,3,0.111111111,1,1.265833333,17.008,115.0,22,60.0,2
2152,5132160,3,2,13,31,4878427,13,24,5.0,11,0.45833333299999995,1,3.415833333,52.824,103.6363636,11,84.61538461538461,2
2153,5131558,2,2,12,43,3636469,11,31,4.333333333,8,0.258064516,1,2.7388888889999996,46.0,119.625,20,72.72727272727273,3
2154,5131314,2,2,14,7,3720071,6,7,4.5,3,0.428571429,1,1.3891666669999998,14.013,100.33333329999999,1,50.0,3
2155,5130032,7,2,12,8,5037932,32,34,4.454545455,25,0.735294118,1,2.130555556,55.872,70.4,2,78.125,7
2156,5124364,1,2,11,22,4770624,12,22,4.4,9,0.409090909,1,2.9472222219999997,50.983000000000004,115.1111111,10,75.0,3
2157,5120155,1,2,17,50,4884584,13,43,4.5,8,0.186046512,1,1.790555556,32.388000000000005,91.75,30,61.53846153846154,5
2158,5116578,4,2,19,1,3354199,12,15,5.0,11,0.7333333329999999,1,2.525277778,37.586999999999996,85.63636364,3,91.66666666666666,1
2159,5115269,2,2,13,49,4151625,18,37,4.0,1,0.027027027000000002,0,0.138611111,4.025,90.0,19,5.555555555555555,17
2160,5114957,1,2,15,37,5159187,27,89,4.5,16,0.179775281,1,5.235277778,102.04299999999999,128.0,62,59.25925925925925,11
2161,5113639,7,2,20,56,5418511,3,37,4.307563701,2,0.054054054000000004,1,0.35472222200000003,7.476,87.0,34,66.66666666666666,1
2162,5109577,3,2,6,17,5385507,4,48,4.0,2,0.041666667000000004,1,0.474722222,8.193999999999999,102.5,44,50.0,2
2163,5105715,2,2,21,15,5278484,4,33,3.0,2,0.060606060999999996,1,0.7405555559999999,13.837,145.5,29,50.0,2
2164,5104140,1,2,18,27,3760346,16,90,4.307563701,5,0.055555556,1,0.446666667,15.269,77.0,74,31.25,11
2165,5099704,3,2,15,17,4784874,3,21,4.307563701,2,0.095238095,1,0.975833333,20.244,189.0,18,66.66666666666666,1
2166,5091241,5,2,12,17,4438916,4,33,4.5,3,0.090909091,1,0.689444444,12.023,97.33333333,29,75.0,1
2167,5085020,1,2,14,43,5364990,22,66,4.0,11,0.166666667,1,3.300833333,58.605,111.6363636,44,50.0,11
2168,5083598,4,2,20,5,5325335,14,38,4.6,8,0.21052631600000002,1,1.406111111,30.963,93.625,24,57.14285714285714,6
2169,5074148,1,2,17,45,5397911,29,37,4.538461538,23,0.621621622,1,6.668888889,112.535,107.21739129999999,8,79.3103448275862,6
2170,5073807,6,2,7,6,5195382,7,19,3.5,6,0.31578947399999996,1,1.3997222219999998,21.589000000000002,90.16666667,12,85.71428571428571,1
2171,5071292,2,2,17,17,5251120,6,93,4.307563701,1,0.010752688,1,0.317777778,7.584,144.0,87,16.666666666666664,5
2172,5067669,2,2,19,33,4735427,3,7,5.0,2,0.28571428600000004,1,0.443055556,7.882000000000001,89.0,4,66.66666666666666,1
2173,5067563,7,2,22,22,5250528,16,43,4.625,14,0.325581395,1,2.3113888890000003,53.78,95.5,27,87.5,2
2174,5060871,6,2,20,52,4269912,9,55,5.0,5,0.090909091,1,0.9725,18.433,90.2,46,55.55555555555556,4
2175,5059411,2,2,16,41,4883464,11,30,4.5,6,0.2,1,1.4983333330000002,28.476,102.83333329999999,19,54.54545454545454,5
2176,5058777,4,2,19,16,4237452,6,35,4.666666667,5,0.14285714300000002,1,1.204166667,21.857,99.0,29,83.33333333333334,1
2177,5058772,7,2,11,53,4722627,5,6,5.0,5,0.833333333,1,1.163055556,26.9,116.0,1,100.0,0
2178,5053020,3,2,19,23,5406572,6,10,4.307563701,2,0.2,1,0.461111111,9.243,99.0,4,33.33333333333333,4
2179,5051111,1,2,8,33,5026422,21,31,4.5,11,0.35483871,1,2.216111111,36.113,80.27272727,10,52.38095238095239,10
2180,5050579,3,2,9,34,5331947,4,42,5.0,2,0.047619048,1,0.5069444439999999,8.314,92.5,38,50.0,2
2181,5037012,2,2,19,14,5087794,4,7,4.0,4,0.571428571,1,1.103611111,13.154000000000002,85.5,3,100.0,0
2182,5034260,7,2,13,34,4858594,8,21,4.5,4,0.19047619,1,0.8113888890000001,19.077,102.0,13,50.0,4
2183,5027785,4,2,20,24,5385484,12,63,4.8,9,0.14285714300000002,1,3.1636111110000003,46.903,112.2222222,51,75.0,3
2184,5027533,4,2,15,8,5093185,9,101,4.0,2,0.01980198,1,1.0122222220000001,18.887,202.0,92,22.22222222222222,7
2185,5026466,2,2,19,56,5346105,4,11,5.0,3,0.272727273,1,0.7202777779999999,15.8,109.66666670000001,7,75.0,1
2186,5025604,2,2,13,20,4734154,5,5,3.333333333,5,1.0,1,1.278333333,21.95,99.0,0,100.0,0
2187,5017116,3,2,20,27,4674029,4,61,4.307563701,1,0.016393443,1,0.0011111110000000001,5.85,118.0,57,25.0,3
2188,5013672,3,2,9,7,3517594,4,22,5.0,3,0.13636363599999998,1,0.82,15.219000000000001,106.0,18,75.0,1
2189,5009215,1,2,12,23,5395545,3,12,4.307563701,2,0.166666667,1,0.782222222,6.394,78.0,9,66.66666666666666,1
2190,5008987,2,2,9,11,4366558,5,7,4.5,5,0.7142857140000001,1,1.155,25.514,106.6,2,100.0,0
2191,5003919,2,2,14,3,5159263,15,30,4.666666667,8,0.26666666699999997,1,2.331111111,39.133,105.0,15,53.333333333333336,7
2192,5003569,2,2,11,35,4319196,9,53,4.0,3,0.056603774,1,0.698611111,15.139000000000001,110.66666670000001,44,33.33333333333333,6
2193,4998307,1,2,9,52,4894063,14,69,5.0,5,0.072463768,1,0.791666667,11.95,66.6,55,35.714285714285715,9
2194,4992675,1,2,13,56,5039655,3,29,4.0,1,0.034482759,0,0.000277778,0.14,45.0,26,33.33333333333333,2
2195,4985947,4,2,19,9,3788891,11,94,4.5,7,0.074468085,1,3.811666667,53.85,148.5714286,83,63.63636363636363,4
2196,4983768,2,2,8,56,5368677,7,31,4.307563701,4,0.129032258,1,0.793055556,20.32,104.25,24,57.14285714285714,3
2197,4978319,1,2,10,36,5358213,6,78,5.0,2,0.025641026,1,0.775277778,9.972000000000001,108.5,72,33.33333333333333,4
2198,4974552,3,2,11,53,4183613,17,39,4.0,13,0.333333333,1,3.1330555560000004,57.857,96.84615385,22,76.47058823529412,4
2199,4970812,5,2,18,54,5096493,3,130,4.307563701,1,0.007692308,1,0.236388889,4.703,96.0,127,33.33333333333333,2
2200,4966942,1,2,19,23,4941777,3,13,4.0,1,0.076923077,0,0.359444444,4.0889999999999995,91.0,10,33.33333333333333,2
2201,4964794,1,2,10,39,3201247,43,89,3.75,26,0.29213483100000004,1,0.46,31.954,58.76923077,46,60.46511627906976,17
2202,4959005,7,2,21,31,5270061,5,19,3.333333333,5,0.263157895,1,2.252222222,38.058,152.4,14,100.0,0
2203,4940743,4,2,20,51,4858594,4,87,4.307563701,2,0.022988506000000002,0,0.319166667,4.3469999999999995,71.0,83,50.0,2
2204,4936527,1,2,22,2,4342314,10,22,4.75,8,0.363636364,1,1.54,41.09,109.75,12,80.0,2
2205,4935246,3,2,21,52,4130929,4,4,4.307563701,2,0.5,0,0.253611111,4.133,67.0,0,50.0,2
2206,4933104,2,2,19,13,4044806,2,2,5.0,2,1.0,1,0.498888889,9.533,107.0,0,100.0,0
2207,4921340,2,2,6,52,4338807,5,21,3.0,2,0.095238095,1,0.499444444,12.947000000000001,127.0,16,40.0,3
2208,4920404,4,2,20,22,3775487,8,47,3.75,8,0.17021276600000002,1,3.087222222,39.352,110.25,39,100.0,0
2209,4915370,5,2,6,9,3510413,4,33,5.0,3,0.090909091,1,0.6361111110000001,10.225,89.0,29,75.0,1
2210,4914169,3,2,9,42,4746220,25,67,4.5,14,0.208955224,1,3.999722222,59.657,95.85714286,42,56.00000000000001,11
2211,4912988,2,2,14,45,5233091,22,69,4.625,20,0.289855072,1,5.370555556,92.072,100.4,47,90.9090909090909,2
2212,4894815,7,2,19,48,4635341,6,16,4.0,5,0.3125,1,1.153333333,24.776,107.8,10,83.33333333333334,1
2213,4894110,1,2,17,58,4723860,9,39,4.75,6,0.153846154,1,1.112222222,16.542,74.16666667,30,66.66666666666666,3
2214,4885806,2,2,13,43,4588775,5,8,4.0,5,0.625,1,0.8211111109999999,14.413,75.8,3,100.0,0
2215,4881324,2,2,17,16,4257471,5,11,4.333333333,4,0.363636364,1,1.265,20.259,114.25,6,80.0,1
2216,4874382,1,2,19,34,4363710,5,43,4.0,5,0.11627907,1,0.0044444440000000005,3.3510000000000004,50.8,38,100.0,0
2217,4873320,1,2,12,37,5156257,5,18,4.5,2,0.111111111,1,0.766388889,12.182,123.0,13,40.0,3
2218,4873262,2,2,9,9,5192968,7,25,4.666666667,6,0.24,1,1.203333333,24.166,90.5,18,85.71428571428571,1
2219,4872236,4,2,16,49,4013903,24,35,4.166666667,14,0.4,1,3.2338888889999997,58.308,98.57142857,11,58.333333333333336,10
2220,4869168,1,2,8,27,4419899,24,35,4.272727273,21,0.6,1,5.251111111,105.411,105.9047619,11,87.5,3
2221,4869098,1,2,12,6,4697877,17,56,4.5,9,0.16071428599999998,1,1.769722222,31.596,83.22222222,39,52.94117647058824,8
2222,4869011,4,2,16,48,3253157,5,32,4.4,5,0.15625,1,1.5052777780000002,27.535999999999998,115.6,27,100.0,0
2223,4864423,3,2,16,28,5403831,6,20,4.5,5,0.25,1,0.8513888890000001,16.594,81.4,14,83.33333333333334,1
2224,4859035,2,2,19,14,4895103,2,28,4.307563701,1,0.035714286,1,0.556944444,10.718,186.0,26,50.0,1
2225,4851938,2,2,11,27,4976454,3,13,4.307563701,2,0.153846154,1,0.670555556,3.885,66.0,10,66.66666666666666,1
2226,4847371,5,2,21,51,5161336,9,24,4.0,2,0.083333333,1,0.265277778,6.358,88.0,15,22.22222222222222,7
2227,4846111,3,2,8,27,3814645,6,19,4.5,4,0.21052631600000002,1,1.774444444,29.816,139.75,13,66.66666666666666,2
2228,4845310,1,2,7,58,4795140,6,24,4.307563701,1,0.041666667000000004,0,0.136388889,3.45,82.0,18,16.666666666666664,5
2229,4842162,7,2,18,57,4930518,17,38,4.8,16,0.42105263200000004,1,4.225555556000001,101.76899999999999,132.6875,21,94.11764705882352,1
2230,4840902,4,2,19,17,5403130,2,12,5.0,1,0.083333333,0,0.220277778,0.054000000000000006,45.0,10,50.0,1
2231,4837771,5,2,18,48,5368563,2,29,5.0,2,0.068965517,1,0.6575,12.187999999999999,125.0,27,100.0,0
2232,4826929,4,2,14,19,5404697,12,53,4.5,11,0.20754717,1,2.1275,40.843,89.09090909,41,91.66666666666666,1
2233,4803005,5,2,17,51,4828677,3,44,5.0,2,0.045454545,1,0.8161111109999999,13.648,132.0,41,66.66666666666666,1
2234,4789669,2,2,6,56,5360900,4,5,4.307563701,1,0.2,1,0.195277778,5.194,108.0,1,25.0,3
2235,4787193,1,2,11,59,4884457,5,9,3.0,3,0.333333333,0,0.324166667,5.1610000000000005,61.33333333,4,60.0,2
2236,4779032,7,2,8,31,4662088,8,14,4.0,6,0.428571429,1,1.694166667,32.3,110.33333329999999,6,75.0,2
2237,4779006,5,2,15,3,4727298,19,21,4.6,13,0.6190476189999999,1,3.751111111,79.859,128.6153846,2,68.42105263157895,6
2238,4778920,1,2,19,39,5395792,9,52,4.5,5,0.096153846,1,2.042222222,34.887,139.0,43,55.55555555555556,4
2239,4778314,1,2,17,14,4412620,3,17,3.666666667,3,0.176470588,1,1.221388889,17.084,114.0,14,100.0,0
2240,4765988,1,2,15,32,3764421,6,11,4.333333333,6,0.545454545,1,1.428611111,27.565,104.0,5,100.0,0
2241,4764392,3,2,9,44,4893320,15,20,4.25,9,0.45,1,2.5927777780000003,34.391999999999996,90.22222222,5,60.0,6
2242,4760636,2,2,16,10,5203284,3,24,5.0,2,0.083333333,1,0.767222222,15.34,145.0,21,66.66666666666666,1
2243,4758711,5,2,16,57,4382125,10,39,3.5,9,0.23076923100000002,1,2.825,46.43899999999999,111.1111111,29,90.0,1
2244,4752376,7,2,14,56,4976251,7,22,4.307563701,3,0.13636363599999998,1,0.868055556,18.206,122.0,15,42.857142857142854,4
2245,4744404,2,2,15,25,3998370,8,25,3.5,7,0.28,1,2.301388889,38.157,112.2857143,17,87.5,1
2246,4741712,3,2,16,12,3376458,19,29,4.333333333,18,0.620689655,1,5.705277777999999,95.553,110.2222222,10,94.73684210526315,1
2247,4737985,2,2,17,10,3783556,12,53,4.0,8,0.150943396,1,2.07,38.799,105.75,41,66.66666666666666,4
2248,4736314,2,2,10,29,5273713,21,74,4.444444444,16,0.21621621600000002,1,5.5886111110000005,94.75,120.375,53,76.19047619047619,5
2249,4735945,4,2,17,52,3927587,19,24,4.4,16,0.666666667,1,4.698611111,80.959,107.6875,5,84.21052631578947,3
2250,4735544,1,2,20,56,4946464,2,3,4.307563701,2,0.666666667,1,0.6166666670000001,14.385,145.0,1,100.0,0
2251,4724464,2,2,12,27,4228037,2,5,3.0,1,0.2,1,0.483055556,7.348,140.0,3,50.0,1
2252,4720103,4,2,18,32,4439356,5,10,4.0,3,0.3,1,0.686111111,11.276,96.0,5,60.0,2
2253,4718962,3,2,8,23,3926096,3,3,5.0,2,0.666666667,1,1.4858333330000002,29.874000000000002,254.0,0,66.66666666666666,1
2254,4716906,2,2,18,7,4172511,17,78,4.2,10,0.128205128,1,3.748333333,60.022,125.6,61,58.82352941176471,7
2255,4706078,5,2,10,40,3073894,2,6,4.0,2,0.333333333,1,0.6180555560000001,10.182,106.5,4,100.0,0
2256,4699129,2,2,14,28,4577554,10,53,3.666666667,5,0.09433962300000001,1,0.997222222,18.309,88.6,43,50.0,5
2257,4693935,3,2,18,33,5272916,4,27,5.0,3,0.111111111,1,0.970833333,18.855999999999998,127.33333329999999,23,75.0,1
2258,4693702,5,2,18,16,3521338,9,45,5.0,4,0.088888889,0,0.001388889,3.445,52.75,36,44.44444444444444,5
2259,4693239,4,2,12,57,4390422,2,28,1.0,2,0.071428571,1,0.835833333,14.843,141.5,26,100.0,0
2260,4692224,5,2,17,58,3641183,7,36,5.0,5,0.13888888900000002,1,1.200277778,14.133,74.6,29,71.42857142857143,2
2261,4679003,1,2,13,32,3332134,33,69,4.285714286,13,0.18840579699999999,1,1.035833333,29.326999999999998,70.38461538,36,39.39393939393939,20
2262,4678744,1,2,22,31,4833032,32,69,4.428571429,15,0.21739130399999998,1,5.028611111,93.55,129.0666667,37,46.875,17
2263,4652677,5,2,16,45,4909284,3,19,4.307563701,1,0.052631579000000005,1,0.334166667,7.709,146.0,16,33.33333333333333,2
2264,4650507,2,2,9,36,4719894,7,25,4.0,3,0.12,1,0.7719444440000001,11.747,94.0,18,42.857142857142854,4
2265,4648430,1,2,12,34,5132315,3,12,4.5,3,0.25,1,1.241944444,19.0,124.0,9,100.0,0
2266,4644837,5,2,14,42,4867221,3,11,5.0,3,0.272727273,1,1.091111111,19.234,132.3333333,8,100.0,0
2267,4644662,1,2,9,51,5093269,10,16,4.0,9,0.5625,1,1.888333333,29.163,81.11111111,6,90.0,1
2268,4643237,4,2,15,1,3600055,13,22,4.6,10,0.454545455,1,3.431666667,45.685,103.4,9,76.92307692307693,3
2269,4631445,1,2,13,27,5359214,13,28,4.333333333,8,0.28571428600000004,1,2.2997222219999998,43.132,113.5,15,61.53846153846154,5
2270,4626035,3,2,9,31,3458489,9,32,4.307563701,2,0.0625,1,0.5563888889999999,7.752000000000001,90.5,23,22.22222222222222,7
2271,4608249,3,2,20,26,5072015,2,14,5.0,2,0.14285714300000002,1,1.0919444440000001,23.02,202.5,12,100.0,0
2272,4599422,2,2,21,8,4913362,2,17,5.0,2,0.117647059,1,0.6980555559999999,14.345999999999998,151.0,15,100.0,0
2273,4599095,2,2,6,17,4589146,5,16,4.0,4,0.25,1,0.861666667,24.425,126.5,11,80.0,1
2274,4574640,4,2,20,55,4380979,4,24,5.0,2,0.083333333,1,0.27388888899999997,5.065,80.0,20,50.0,2
2275,4573162,3,2,10,58,4339074,6,17,5.0,4,0.235294118,1,1.175833333,17.713,101.5,11,66.66666666666666,2
2276,4566970,1,2,12,21,3658079,9,11,5.0,6,0.545454545,1,1.811666667,29.945,104.83333329999999,2,66.66666666666666,3
2277,4553688,4,2,9,42,4984364,3,15,4.0,2,0.133333333,1,0.47861111100000003,6.006,92.5,12,66.66666666666666,1
2278,4541888,5,2,8,45,3607662,2,7,5.0,2,0.28571428600000004,1,0.4975,10.673,111.5,5,100.0,0
2279,4541189,2,2,13,15,5150614,13,36,5.0,8,0.222222222,1,2.729722222,45.52,116.0,23,61.53846153846154,5
2280,4535225,4,2,11,35,5389779,3,5,4.307563701,1,0.2,1,0.317777778,6.434,127.0,2,33.33333333333333,2
2281,4518689,4,2,14,27,5197316,23,55,3.0,5,0.090909091,1,0.895833333,26.807,117.4,32,21.73913043478261,18
2282,4517432,7,2,11,58,4998325,8,19,4.25,7,0.36842105299999994,1,1.438333333,28.901999999999997,93.57142857,11,87.5,1
2283,4511571,1,2,13,59,3859891,4,14,4.307563701,2,0.14285714300000002,1,0.715555556,12.434000000000001,125.0,10,50.0,2
2284,4499526,1,2,11,6,4920074,6,24,4.666666667,4,0.166666667,1,1.4505555559999999,23.245,118.0,18,66.66666666666666,2
2285,4486294,4,2,16,37,4992841,15,32,4.166666667,12,0.375,1,4.098055556,53.165,99.83333333,17,80.0,3
2286,4472631,7,2,17,16,4992224,25,49,4.333333333,17,0.346938776,1,3.206388889,57.413999999999994,86.41176471,24,68.0,8
2287,4465664,2,2,19,13,3495246,16,32,3.5,9,0.28125,1,2.7002777780000002,52.434,123.2222222,16,56.25,7
2288,4465655,2,2,21,4,5122490,5,65,4.307563701,1,0.015384615,1,0.23305555600000002,4.783,119.0,60,20.0,4
2289,4465335,7,2,11,53,5317965,6,26,5.0,5,0.192307692,1,1.270833333,25.111,104.0,20,83.33333333333334,1
2290,4463621,3,2,15,19,4766692,2,10,5.0,1,0.1,0,0.185277778,0.19,45.0,8,50.0,1
2291,4450526,3,2,9,27,4635168,10,41,1.0,8,0.19512195100000002,1,2.148611111,40.294000000000004,105.75,31,80.0,2
2292,4449056,4,2,17,35,4046706,6,24,5.0,6,0.25,1,1.295,22.535,91.16666667,18,100.0,0
2293,4448069,7,2,20,21,4594431,5,31,5.0,4,0.129032258,1,0.7525,17.852,107.75,26,80.0,1
2294,4441147,4,2,16,57,4628383,12,18,4.25,8,0.444444444,1,1.976666667,43.538000000000004,119.0,6,66.66666666666666,4
2295,4423937,5,2,11,23,3723701,10,48,4.0,7,0.145833333,1,1.884166667,30.439,95.85714286,38,70.0,3
2296,4417549,7,2,16,12,5009165,15,53,3.0,8,0.150943396,1,2.472222222,49.023999999999994,123.125,38,53.333333333333336,7
2297,4414917,1,2,10,22,4902734,13,15,3.25,11,0.7333333329999999,1,2.243611111,39.496,85.63636364,2,84.61538461538461,2
2298,4409274,4,2,13,24,3262567,11,59,4.666666667,8,0.13559322,1,1.8802777780000002,31.895,90.625,48,72.72727272727273,3
2299,4408251,3,2,10,54,4825468,11,37,5.0,8,0.21621621600000002,1,2.506944444,49.223,123.375,26,72.72727272727273,3
2300,4398856,2,2,17,58,3595739,12,26,5.0,9,0.346153846,1,2.810833333,43.233999999999995,102.33333329999999,14,75.0,3
2301,4393331,4,2,10,34,5331375,10,37,5.0,6,0.162162162,1,2.156388889,36.174,127.33333329999999,27,60.0,4
2302,4391733,2,2,14,1,4372939,12,50,4.666666667,6,0.12,1,1.1319444440000002,15.722000000000001,71.33333333,38,50.0,6
2303,4364809,5,2,17,25,5346714,20,35,3.888888889,13,0.37142857100000004,1,4.095277778,57.358000000000004,101.5384615,15,65.0,7
2304,4360849,5,2,20,51,4690835,10,17,4.5,6,0.352941176,1,1.303055556,33.001999999999995,125.5,7,60.0,4
2305,4358301,1,2,21,23,4883391,7,18,4.333333333,5,0.27777777800000003,1,1.511111111,28.151,117.8,11,71.42857142857143,2
2306,4349687,2,2,4,28,5389659,14,23,4.0,9,0.39130434799999997,1,1.6025,34.592,113.33333329999999,9,64.28571428571429,5
2307,4348516,3,2,13,48,5378272,23,75,4.0,14,0.18666666699999998,1,4.807222222,69.639,105.3571429,52,60.86956521739131,9
2308,4331031,7,2,10,24,4147210,5,11,5.0,5,0.454545455,1,1.100555556,20.177,96.4,6,100.0,0
2309,4323923,4,2,18,50,5419567,12,26,4.166666667,8,0.307692308,1,0.518888889,24.833000000000002,86.25,14,66.66666666666666,4
2310,4323594,3,2,14,11,4833044,17,28,3.727272727,14,0.5,1,5.033888889,88.307,125.1428571,11,82.35294117647058,3
2311,4264013,5,2,19,15,4868795,4,15,4.0,3,0.2,1,1.222222222,20.753,135.0,11,75.0,1
2312,4252642,1,2,7,46,4637047,4,7,3.5,4,0.571428571,1,0.905833333,21.683000000000003,111.0,3,100.0,0
2313,4242380,5,2,15,31,5350504,9,21,4.0,8,0.380952381,1,1.815277778,33.604,97.75,12,88.88888888888889,1
2314,4206397,5,2,12,20,5421586,12,22,4.833333333,8,0.363636364,1,2.150833333,38.352,105.5,10,66.66666666666666,4
2315,4195507,4,2,18,1,3473617,15,25,4.0,10,0.4,1,2.088611111,36.751999999999995,87.4,10,66.66666666666666,5
2316,4195279,2,2,11,4,4479999,4,19,5.0,2,0.10526315800000001,1,0.680555556,12.26,131.0,15,50.0,2
2317,4195214,7,2,12,33,5196596,6,15,4.5,5,0.333333333,1,1.244166667,18.019000000000002,86.0,9,83.33333333333334,1
2318,4189983,4,2,19,28,4907330,3,84,5.0,1,0.011904762,1,0.000555556,6.7829999999999995,145.0,81,33.33333333333333,2
2319,4165162,1,2,12,19,5359395,15,31,4.714285714,11,0.35483871,1,4.3552777780000005,77.035,136.4545455,16,73.33333333333333,4
2320,4146452,6,2,18,1,4130707,4,15,4.307563701,1,0.066666667,1,0.385555556,7.71,160.0,11,25.0,3
2321,4132052,2,2,7,24,4577428,6,44,4.307563701,2,0.045454545,1,0.8886111109999999,16.041,157.0,38,33.33333333333333,4
2322,4126536,3,2,19,34,5111627,7,40,4.0,4,0.1,0,0.6397222220000001,6.1370000000000005,56.75,33,57.14285714285714,3
2323,4120139,4,2,21,3,3507658,5,21,5.0,4,0.19047619,1,0.582777778,21.15,120.25,16,80.0,1
2324,4113024,1,2,11,45,5145823,5,12,4.666666667,5,0.41666666700000005,1,1.324444444,21.994,98.4,7,100.0,0
2325,4112660,1,2,12,44,4041851,8,26,4.333333333,5,0.192307692,1,1.6938888890000001,38.594,143.4,18,62.5,3
2326,4112114,1,2,18,54,3719359,8,59,4.5,2,0.033898305,1,0.449722222,7.056,83.0,51,25.0,6
2327,4089258,3,2,17,44,3050740,2,7,4.5,2,0.28571428600000004,1,0.473055556,6.524,79.0,5,100.0,0
2328,4082745,1,2,11,31,5387702,14,57,4.5,7,0.122807018,1,1.7572222219999998,30.463,97.28571429,43,50.0,7
2329,4059098,4,2,15,41,5222389,10,22,5.0,6,0.272727273,1,1.115555556,14.196,70.66666667,12,60.0,4
2330,4049877,5,2,16,49,5426511,3,11,4.307563701,1,0.090909091,0,0.17472222199999998,3.235,79.0,8,33.33333333333333,2
2331,4048554,4,2,17,37,5079011,3,18,4.0,2,0.111111111,1,0.395,4.837,68.5,15,66.66666666666666,1
2332,4042274,7,2,6,47,5339794,12,27,5.0,6,0.222222222,1,2.415277778,36.619,130.1666667,15,50.0,6
2333,4041156,7,2,19,18,3169358,10,41,3.0,2,0.048780488,1,0.504166667,5.225,76.0,31,20.0,8
2334,4040845,1,2,12,19,4740751,9,22,5.0,5,0.22727272699999998,1,1.4066666669999999,21.765,97.0,13,55.55555555555556,4
2335,4035227,1,2,11,18,4639862,11,159,4.75,6,0.037735849,1,1.172777778,21.449,86.66666667,148,54.54545454545454,5
2336,4034260,3,2,10,27,4716784,36,54,4.0,17,0.314814815,1,5.418611111000001,78.42699999999999,100.7647059,18,47.22222222222222,19
2337,4029348,2,2,11,56,4086936,3,9,5.0,1,0.111111111,1,0.163888889,5.445,112.0,6,33.33333333333333,2
2338,4019859,2,2,17,48,4874575,12,34,4.0,2,0.058823529000000006,1,0.633055556,7.171,88.0,22,16.666666666666664,10
2339,4018319,4,2,13,42,5172591,2,7,4.307563701,2,0.28571428600000004,1,0.738055556,13.57,131.5,5,100.0,0
2340,4009983,4,2,19,19,4488467,4,10,5.0,3,0.3,1,0.381944444,9.187999999999999,83.66666667,6,75.0,1
2341,4001814,7,2,9,11,4534436,9,31,4.75,8,0.258064516,1,2.668611111,51.332,128.25,22,88.88888888888889,1
2342,3996797,2,2,18,16,3830398,13,22,5.0,9,0.409090909,1,2.593333333,48.608000000000004,117.8888889,9,69.23076923076923,4
2343,3994570,4,2,14,50,4186142,4,17,3.0,3,0.176470588,1,0.35194444399999997,4.629,54.66666667,13,75.0,1
2344,3961795,2,2,6,20,3091607,7,9,5.0,6,0.666666667,1,2.053055556,37.707,122.83333329999999,2,85.71428571428571,1
2345,3944425,2,2,15,24,4092705,2,24,4.0,1,0.041666667000000004,1,0.114166667,2.9,74.0,22,50.0,1
2346,3936414,2,2,17,12,5369526,12,31,4.0,7,0.225806452,1,2.493611111,40.798,124.57142859999999,19,58.333333333333336,5
2347,3917460,3,2,12,21,4745875,9,15,2.5,5,0.333333333,1,2.48,31.355,127.8,6,55.55555555555556,4
2348,3904462,5,2,12,15,5371613,3,19,5.0,2,0.10526315800000001,1,0.000277778,11.885,123.5,16,66.66666666666666,1
2349,3867133,7,2,22,1,4861095,4,12,4.307563701,1,0.083333333,0,0.043333332999999995,0.21600000000000003,45.0,8,25.0,3
2350,3840723,2,2,13,13,3866088,5,16,4.0,1,0.0625,1,0.239166667,5.24,109.0,11,20.0,4
2351,3809961,4,2,18,1,5189074,18,45,4.25,9,0.2,1,2.0775,32.783,87.55555556,27,50.0,9
2352,3798866,5,2,9,34,4931383,7,29,5.0,5,0.172413793,1,2.196388889,29.689,127.6,22,71.42857142857143,2
2353,3757071,3,2,11,21,4556080,2,3,3.0,1,0.333333333,0,0.122777778,4.077,91.0,1,50.0,1
2354,3754231,2,2,13,4,3968973,17,50,4.333333333,9,0.18,1,3.758333333,50.42,114.44444440000001,33,52.94117647058824,8
2355,3751566,1,2,8,43,3941712,10,31,4.666666667,7,0.225806452,1,1.6627777780000002,26.344,85.85714286,21,70.0,3
2356,3694253,5,2,15,42,4810098,6,24,1.0,2,0.083333333,1,0.42166666700000005,8.384,100.0,18,33.33333333333333,4
2357,3688501,2,2,7,21,5050224,8,16,4.307563701,1,0.0625,1,0.318055556,8.892999999999999,163.0,8,12.5,7
2358,3683496,1,2,12,19,3489192,11,17,4.0,7,0.41176470600000004,1,2.474722222,39.938,116.7142857,6,63.63636363636363,4
2359,3670054,2,2,20,7,3523686,2,41,3.0,1,0.024390244,1,0.23,3.988,101.0,39,50.0,1
2360,3648810,2,2,19,3,5326211,10,52,4.5,5,0.096153846,1,1.290555556,26.508000000000003,109.4,42,50.0,5
2361,3638440,2,2,11,27,5206317,9,28,4.0,4,0.14285714300000002,1,0.7352777779999999,12.657,90.25,19,44.44444444444444,5
2362,3635024,2,2,9,21,3984869,13,28,4.0,11,0.39285714299999996,1,2.8002777780000003,49.349,99.54545455,15,84.61538461538461,2
2363,3564741,7,2,22,53,5255314,2,25,5.0,1,0.04,1,0.0975,2.021,69.0,23,50.0,1
2364,3500029,2,2,16,50,4945721,3,14,5.0,2,0.14285714300000002,1,0.579722222,8.779,101.5,11,66.66666666666666,1
2365,3475860,3,2,15,3,5052229,5,44,4.0,3,0.06818181799999999,1,0.991944444,22.369,145.66666669999998,39,60.0,2
2366,3466729,6,2,11,6,3703276,4,48,5.0,2,0.041666667000000004,0,0.35666666700000005,3.324,72.5,44,50.0,2
2367,3434085,1,2,12,40,4400689,2,17,4.307563701,1,0.058823529000000006,1,0.6769444440000001,10.537,188.0,15,50.0,1
2368,3421486,1,2,10,19,3252228,12,80,4.333333333,3,0.0375,1,0.841944444,16.224,126.0,68,25.0,9
2369,3349614,3,2,10,49,5358327,3,29,4.307563701,1,0.034482759,1,0.000555556,5.877999999999999,118.0,26,33.33333333333333,2
2370,3346396,1,2,11,54,4197346,13,14,3.8,10,0.7142857140000001,1,2.8711111110000003,48.488,105.8,1,76.92307692307693,3
2371,3212558,2,2,18,42,5366712,4,9,4.307563701,1,0.111111111,1,0.000555556,6.38,126.0,5,25.0,3
2372,3201165,1,2,9,50,5219924,6,7,5.0,5,0.7142857140000001,1,1.5475,28.291999999999998,118.6,1,83.33333333333334,1
2373,3132746,1,2,15,16,4398515,12,20,2.5,3,0.15,1,1.168611111,15.487,106.33333329999999,8,25.0,9
2374,3120350,2,2,15,13,3054033,9,29,4.0,6,0.20689655199999998,1,2.81,52.251999999999995,163.33333330000002,20,66.66666666666666,3
2375,3112556,5,2,18,1,3627200,3,14,5.0,2,0.14285714300000002,0,0.551944444,6.943,86.0,11,66.66666666666666,1
2376,3096858,2,2,12,28,4347059,3,31,4.307563701,1,0.032258065,1,0.0011111110000000001,1.3430000000000002,50.0,28,33.33333333333333,2
2377,2998385,3,2,8,10,3781104,4,25,5.0,2,0.08,1,0.494444444,11.072000000000001,113.0,21,50.0,2
2378,2955780,7,2,17,30,4745942,6,8,4.5,4,0.5,1,0.994722222,20.543000000000003,116.5,2,66.66666666666666,2
2379,2936464,2,2,18,30,4972000,12,58,4.0,3,0.051724137999999996,1,0.238055556,7.346,66.66666667,46,25.0,9
2380,2930590,7,2,14,11,5092840,2,39,4.307563701,1,0.025641026,1,0.380833333,8.309,155.0,37,50.0,1
2381,2926841,2,2,6,23,4900462,26,67,4.4,8,0.119402985,1,1.821388889,38.198,103.875,41,30.76923076923077,18
2382,2914830,2,2,12,17,5009304,2,9,5.0,1,0.111111111,1,0.42722222200000004,9.048,170.0,7,50.0,1
2383,2912701,7,2,12,40,4522848,15,27,4.333333333,10,0.37037037,1,2.198611111,54.104,111.1,12,66.66666666666666,5
2384,2905099,2,2,13,4,5251527,2,12,4.307563701,1,0.083333333,1,0.303055556,5.218,108.0,10,50.0,1
2385,5441667,7,1,18,54,4831321,1,4,4.307563701,1,0.25,1,0.6775,5.013,115.0,3,100.0,0
2386,5441518,7,1,17,44,4723476,6,10,4.307563701,4,0.4,1,0.647222222,16.555999999999997,94.5,4,66.66666666666666,2
2387,5441296,7,1,17,53,4043346,3,4,4.0,3,0.75,1,1.110833333,26.753,163.66666669999998,1,100.0,0
2388,5441084,7,1,18,16,4100663,9,17,4.75,8,0.470588235,1,1.654722222,34.671,99.125,8,88.88888888888889,1
2389,5440699,7,1,20,22,3108843,5,5,4.307563701,5,1.0,1,1.136666667,20.227999999999998,93.4,0,100.0,0
2390,5440226,7,1,18,33,3926093,2,12,4.0,2,0.166666667,1,0.311944444,5.067,68.0,10,100.0,0
2391,5439508,7,1,17,19,4209697,7,32,4.6,6,0.1875,1,1.771111111,53.485,165.5,25,85.71428571428571,1
2392,5439220,7,1,15,18,3931566,7,15,5.0,4,0.26666666699999997,1,0.799166667,10.624,70.25,8,57.14285714285714,3
2393,5439209,7,1,14,53,4724111,8,27,5.0,8,0.296296296,1,1.4947222219999998,36.306999999999995,100.75,19,100.0,0
2394,5438905,7,1,19,57,5290291,9,9,4.5,6,0.666666667,1,1.4113888890000001,28.881999999999998,108.66666670000001,0,66.66666666666666,3
2395,5438810,7,1,12,38,3755860,5,16,4.666666667,5,0.3125,1,1.413055556,37.777,142.0,11,100.0,0
2396,5433842,7,1,18,4,4407226,2,6,4.307563701,1,0.166666667,1,0.271944444,5.382000000000001,116.0,4,50.0,1
2397,5433621,6,1,16,21,5122653,2,10,4.307563701,2,0.2,1,0.229166667,4.038,66.0,8,100.0,0
2398,5433339,7,1,20,16,4912280,13,25,3.777777778,13,0.52,1,2.329166667,48.836999999999996,86.69230769,12,100.0,0
2399,5428241,7,1,16,17,4338782,3,20,5.0,2,0.1,1,0.18333333300000001,4.556,64.0,17,66.66666666666666,1
2400,5427166,7,1,14,47,4427621,9,39,3.666666667,6,0.153846154,1,4.1052777780000005,35.242,126.0,30,66.66666666666666,3
2401,5427100,5,1,21,21,3287819,8,8,4.5,7,0.875,1,1.023888889,22.594,89.42857143,0,87.5,1
2402,5426733,7,1,16,45,3064849,6,20,5.0,5,0.25,1,0.953333333,23.605999999999998,102.6,14,83.33333333333334,1
2403,5426689,7,1,13,21,3466113,6,17,4.0,4,0.235294118,1,0.575555556,10.964,71.5,11,66.66666666666666,2
2404,5426251,7,1,10,1,5340979,7,24,4.0,5,0.208333333,1,0.953888889,24.055,114.6,17,71.42857142857143,2
2405,5426063,5,1,17,8,3747720,2,4,4.307563701,1,0.25,1,0.144166667,2.394,66.0,2,50.0,1
2406,5424925,7,1,9,56,5438600,5,9,3.75,5,0.5555555560000001,1,0.918333333,21.46,95.8,4,100.0,0
2407,5419151,5,1,14,44,5302028,4,22,5.0,2,0.090909091,0,0.324722222,6.61,84.5,18,50.0,2
2408,5419099,5,1,11,26,3460210,3,5,4.307563701,1,0.2,1,0.34305555600000004,3.795,87.0,2,33.33333333333333,2
2409,5418636,6,1,6,45,4520671,7,37,4.75,6,0.162162162,1,1.523888889,27.699,108.66666670000001,30,85.71428571428571,1
2410,5414981,7,1,17,0,5441678,1,2,4.0,1,0.5,1,0.48222222200000003,9.173,170.0,1,100.0,0
2411,5411627,5,1,8,35,5424053,5,20,4.5,5,0.25,1,1.3155555559999998,19.105999999999998,89.2,15,100.0,0
2412,5411514,5,1,13,18,3791441,6,17,5.0,5,0.294117647,1,1.433055556,22.784000000000002,105.0,11,83.33333333333334,1
2413,5411105,5,1,9,6,3090772,2,3,4.307563701,2,0.666666667,1,0.328333333,5.577000000000001,72.0,1,100.0,0
2414,5410648,4,1,14,0,4623428,4,13,4.5,3,0.23076923100000002,1,0.742222222,6.055,67.33333333,9,75.0,1
2415,5410525,7,1,16,19,4799002,9,22,4.666666667,6,0.272727273,1,1.407222222,31.999000000000002,115.66666670000001,13,66.66666666666666,3
2416,5410416,5,1,10,22,4611597,5,33,4.0,2,0.060606060999999996,1,0.23,2.9360000000000004,52.0,28,40.0,3
2417,5405571,6,1,12,8,4342233,3,30,4.0,2,0.066666667,1,0.000555556,3.0660000000000003,61.5,27,66.66666666666666,1
2418,5397354,7,1,19,34,3806003,3,7,5.0,3,0.428571429,1,0.813888889,10.841,83.66666667,4,100.0,0
2419,5395841,2,1,13,36,3148595,7,8,5.0,4,0.5,1,1.8775,23.214000000000002,117.0,1,57.14285714285714,3
2420,5383385,1,1,20,24,4672400,1,6,4.307563701,1,0.166666667,1,0.2375,4.207,93.0,5,100.0,0
2421,5381338,1,1,18,22,5084508,4,6,3.5,3,0.5,1,0.955555556,10.568,86.33333333,2,75.0,1
2422,5380528,2,1,13,42,5083223,2,3,5.0,2,0.666666667,1,0.40805555600000004,9.006,97.5,1,100.0,0
2423,5373364,3,1,12,53,4773265,2,3,4.307563701,2,0.666666667,1,0.39555555600000003,8.08,90.0,1,100.0,0
2424,5371150,1,1,11,54,4696995,2,7,4.307563701,2,0.28571428600000004,1,0.49472222200000004,7.246,84.5,5,100.0,0
2425,5369702,1,1,17,59,4432392,9,26,5.0,6,0.23076923100000002,1,2.370277778,30.587,108.83333329999999,17,66.66666666666666,3
2426,5369334,3,1,15,54,4789666,2,16,4.0,2,0.125,1,1.099722222,17.548,161.5,14,100.0,0
2427,5369075,1,1,10,21,4371204,7,19,4.307563701,2,0.10526315800000001,1,0.8655555559999999,12.431,134.0,12,28.57142857142857,5
2428,5367355,1,1,9,52,5394013,3,10,3.5,2,0.2,1,0.37777777799999995,4.973,75.0,7,66.66666666666666,1
2429,5367202,5,1,10,49,4271738,1,17,4.307563701,1,0.058823529000000006,1,0.011944443999999999,0.006999999999999999,45.0,16,100.0,0
2430,5366544,1,1,10,34,4650259,3,10,4.307563701,1,0.1,0,0.030833332999999997,0.769,45.0,7,33.33333333333333,2
2431,5363414,4,1,18,23,4467533,1,11,4.307563701,1,0.090909091,1,0.18611111100000002,4.031000000000001,100.0,10,100.0,0
2432,5362305,3,1,13,47,4285010,5,13,5.0,1,0.076923077,1,0.213333333,3.145,77.0,8,20.0,4
2433,5361769,7,1,11,3,5242788,13,26,3.5,8,0.307692308,1,2.834166667,42.878,115.625,13,61.53846153846154,5
2434,5360654,2,1,15,22,4784813,1,3,5.0,1,0.333333333,1,0.341388889,7.022,133.0,2,100.0,0
2435,5360554,2,1,11,42,4337906,3,5,2.5,3,0.6,1,0.441388889,5.9879999999999995,64.66666667,2,100.0,0
2436,5356133,1,1,11,56,3254342,5,10,3.333333333,3,0.3,1,0.703888889,11.312000000000001,89.0,5,60.0,2
2437,5355952,1,1,11,47,4023677,1,3,4.307563701,1,0.333333333,1,0.528888889,8.419,145.0,2,100.0,0
2438,5355449,5,1,9,5,5240478,2,70,4.307563701,2,0.028571429,1,0.993055556,15.625,167.0,68,100.0,0
2439,5355391,5,1,10,26,4746134,3,22,4.307563701,2,0.090909091,0,0.347777778,5.067,74.5,19,66.66666666666666,1
2440,5354383,1,1,12,40,3793132,11,17,4.307563701,2,0.117647059,1,0.358888889,4.8839999999999995,66.5,6,18.181818181818183,9
2441,5346359,3,1,9,52,3883517,6,16,4.0,4,0.25,1,0.966666667,18.657,101.0,10,66.66666666666666,2
2442,5341210,2,1,8,53,5397366,14,15,5.0,11,0.7333333329999999,1,3.455,55.74,105.9090909,1,78.57142857142857,3
2443,5340445,4,1,14,20,5352420,3,8,4.307563701,2,0.25,1,0.39805555600000003,6.537000000000001,79.0,5,66.66666666666666,1
2444,5339878,2,1,18,16,3782533,5,7,4.307563701,5,0.7142857140000001,1,2.2602777780000003,20.636999999999997,91.8,2,100.0,0
2445,5339790,2,1,13,53,4153801,3,7,5.0,1,0.14285714300000002,0,0.231111111,3.5639999999999996,85.0,4,33.33333333333333,2
2446,5338953,4,1,17,31,4650902,2,2,4.0,2,1.0,1,0.644166667,3.237,54.5,0,100.0,0
2447,5334236,1,1,11,5,5310790,3,6,5.0,2,0.333333333,1,0.496944444,10.369000000000002,115.5,3,66.66666666666666,1
2448,5334091,1,1,15,48,3368680,5,28,4.0,2,0.071428571,1,0.24638888899999997,4.008,60.0,23,40.0,3
2449,5333568,1,1,12,9,4553161,2,7,5.0,1,0.14285714300000002,1,0.132777778,2.574,69.0,5,50.0,1
2450,5332449,7,1,16,55,4778038,12,14,4.5,10,0.7142857140000001,1,1.947222222,40.664,94.3,2,83.33333333333334,2
2451,5332342,2,1,10,31,4233449,7,9,3.0,3,0.333333333,1,0.6125,13.181,96.0,2,42.857142857142854,4
2452,5332254,6,1,19,55,5235529,3,17,5.0,3,0.176470588,1,0.200833333,4.294,61.0,14,100.0,0
2453,5329133,1,1,9,18,3984869,16,41,4.0,6,0.146341463,1,1.4058333330000001,26.1,107.83333329999999,25,37.5,10
2454,5326434,3,1,11,14,4692894,2,2,4.307563701,2,1.0,1,1.184722222,12.448,134.0,0,100.0,0
2455,5325592,5,1,13,58,4570937,4,12,5.0,4,0.333333333,1,0.771388889,14.552,84.75,8,100.0,0
2456,5325002,5,1,11,0,3453333,2,71,5.0,1,0.014084507,1,0.261944444,6.341,125.0,69,50.0,1
2457,5324537,2,1,10,26,4310336,3,10,4.307563701,1,0.1,1,0.643611111,5.836,135.0,7,33.33333333333333,2
2458,5323842,7,1,14,21,4283393,9,19,4.5,9,0.473684211,1,1.736666667,19.623,75.55555556,10,100.0,0
2459,5323821,7,1,12,45,4980063,4,18,4.0,2,0.111111111,1,0.219444444,4.101,61.0,14,50.0,2
2460,5318376,1,1,11,23,4728891,1,1,4.307563701,1,1.0,1,0.255,3.052,80.0,0,100.0,0
2461,5317671,1,1,16,17,4218726,10,15,5.0,8,0.533333333,1,2.9825,39.733000000000004,108.625,5,80.0,2
2462,5317507,6,1,13,51,5305507,7,43,4.5,5,0.11627907,1,1.634722222,14.522,85.8,36,71.42857142857143,2
2463,5312004,4,1,18,27,5037912,2,10,4.307563701,1,0.1,0,0.146111111,2.987,83.0,8,50.0,1
2464,5311176,1,1,13,1,3996795,11,22,4.75,7,0.318181818,1,2.150277778,33.912,102.7142857,11,63.63636363636363,4
2465,5310994,1,1,8,36,4296815,7,17,4.307563701,4,0.235294118,1,1.053055556,22.299,112.25,10,57.14285714285714,3
2466,5308944,2,1,8,50,4954429,1,2,4.307563701,1,0.5,1,0.521111111,6.3870000000000005,126.0,1,100.0,0
2467,5305674,2,1,13,25,4995461,3,3,4.666666667,3,1.0,1,0.857777778,10.852,84.0,0,100.0,0
2468,5302685,4,1,15,29,4269158,5,5,4.307563701,1,0.2,1,0.39916666700000003,7.313,143.0,0,20.0,4
2469,5302516,2,1,14,9,5270834,5,18,3.5,4,0.222222222,1,1.0655555559999998,23.467,119.5,13,80.0,1
2470,5302481,7,1,16,13,5345396,21,31,4.3,18,0.580645161,1,3.202777778,84.654,103.0,10,85.71428571428571,3
2471,5294837,1,1,9,16,5277857,2,5,3.0,2,0.4,1,0.6347222220000001,9.097000000000001,100.0,3,100.0,0
2472,5290055,1,1,6,9,5393850,2,7,4.0,1,0.14285714300000002,1,0.12166666699999999,3.385,81.0,5,50.0,1
2473,5288312,2,1,11,48,3246638,4,8,4.333333333,4,0.5,1,1.143333333,20.012,114.0,4,100.0,0
2474,5286793,2,1,14,20,5069861,2,12,4.307563701,2,0.166666667,1,0.901388889,13.619000000000002,125.5,10,100.0,0
2475,5286608,2,1,19,46,3651020,4,6,5.0,3,0.5,1,0.7144444440000001,11.72,85.33333333,2,75.0,1
2476,5286121,5,1,12,3,4867196,1,18,4.307563701,1,0.055555556,1,0.3375,4.796,112.0,17,100.0,0
2477,5285833,2,1,19,2,3126045,7,13,5.0,4,0.307692308,1,1.029722222,15.202,88.5,6,57.14285714285714,3
2478,5275005,4,1,17,23,4940157,4,28,4.0,3,0.107142857,1,1.101388889,13.954,102.66666670000001,24,75.0,1
2479,5264496,3,1,13,15,4044145,1,4,4.307563701,1,0.25,1,0.501388889,8.115,152.0,3,100.0,0
2480,5263235,2,1,8,27,4371442,2,9,5.0,2,0.222222222,1,0.775833333,16.029,160.0,7,100.0,0
2481,5257974,2,1,12,33,5280628,11,11,3.5,3,0.272727273,1,0.847777778,11.334000000000001,86.33333333,0,27.27272727272727,8
2482,5249943,3,1,11,42,5221218,1,1,4.307563701,1,1.0,1,0.43777777799999995,7.03,150.0,0,100.0,0
2483,5239253,2,1,12,54,4047764,5,9,3.0,4,0.444444444,1,1.4325,21.226,114.25,4,80.0,1
2484,5230512,1,1,10,16,4995394,1,3,4.307563701,1,0.333333333,1,0.642777778,12.012,210.0,2,100.0,0
2485,5229395,1,1,10,31,5169028,1,20,5.0,1,0.05,1,0.000277778,0.003,45.0,19,100.0,0
2486,5227310,3,1,17,18,5232952,6,10,5.0,1,0.1,1,0.211388889,2.7430000000000003,71.0,4,16.666666666666664,5
2487,5226790,4,1,20,47,3494017,1,1,4.0,1,1.0,1,0.28055555600000004,5.382999999999999,122.0,0,100.0,0
2488,5225579,1,1,9,35,4604755,3,10,5.0,3,0.3,1,1.140277778,21.857,145.33333330000002,7,100.0,0
2489,5225299,1,1,7,36,4677478,2,2,4.307563701,1,0.5,1,0.265277778,7.796,147.0,0,50.0,1
2490,5221152,1,1,8,34,4362769,3,18,4.307563701,1,0.055555556,1,0.22305555600000002,5.907,119.0,15,33.33333333333333,2
2491,5220621,7,1,12,39,4848000,6,32,4.0,5,0.15625,1,0.597777778,14.475,72.0,26,83.33333333333334,1
2492,5220398,1,1,20,20,5101617,8,18,4.5,6,0.333333333,1,1.9458333330000002,37.293,123.33333329999999,10,75.0,2
2493,5219684,1,1,13,0,3257694,4,4,4.333333333,4,1.0,1,0.737777778,15.267000000000001,92.75,0,100.0,0
2494,5219121,7,1,13,22,5233005,6,14,2.0,4,0.28571428600000004,1,1.223055556,28.296,131.5,8,66.66666666666666,2
2495,5218158,5,1,12,45,5153576,1,6,1.0,1,0.166666667,1,0.535,13.405,277.0,5,100.0,0
2496,5218127,1,1,12,32,4452701,6,23,5.0,3,0.130434783,1,0.8169444440000001,11.582,91.0,17,50.0,3
2497,5217465,4,1,15,44,3804593,4,20,1.0,4,0.2,1,1.1311111109999998,13.835,93.5,16,100.0,0
2498,5213646,3,1,18,20,4368926,4,32,4.0,4,0.125,1,0.6180555560000001,8.397,63.25,28,100.0,0
2499,5212684,7,1,16,4,4516720,2,5,4.307563701,1,0.2,0,0.0025,0.001,45.0,3,50.0,1
2500,5210877,2,1,18,51,4738345,3,14,4.0,1,0.071428571,1,0.343888889,5.176,108.0,11,33.33333333333333,2
2501,5210811,7,1,11,21,4449046,3,16,5.0,3,0.1875,1,0.628611111,15.494000000000002,110.66666670000001,13,100.0,0
2502,5209456,5,1,10,39,4302765,1,3,5.0,1,0.333333333,1,0.276111111,3.7089999999999996,86.0,2,100.0,0
2503,5206160,3,1,10,49,3830159,7,13,4.666666667,4,0.307692308,1,1.655277778,27.386,135.75,6,57.14285714285714,3
2504,5204713,1,1,19,38,3554697,5,27,5.0,5,0.185185185,1,0.9386111109999999,19.671,96.0,22,100.0,0
2505,5203834,2,1,5,36,5401325,3,3,4.0,2,0.666666667,1,0.401111111,9.405,100.5,0,66.66666666666666,1
2506,5198143,3,1,18,9,4946478,2,11,4.307563701,1,0.090909091,1,0.302222222,3.627,84.0,9,50.0,1
2507,5197853,5,1,14,10,3466127,1,6,4.0,1,0.166666667,1,0.000833333,0.013999999999999999,45.0,5,100.0,0
2508,5197336,2,1,7,40,4237232,2,13,1.0,1,0.076923077,1,0.263333333,6.402,123.0,11,50.0,1
2509,5193630,2,1,17,0,3343923,5,15,5.0,4,0.26666666699999997,1,1.7625,30.746,146.0,10,80.0,1
2510,5180805,1,1,18,21,3473617,7,10,4.25,7,0.7,1,1.4058333330000001,34.493,107.57142859999999,3,100.0,0
2511,5175458,3,1,18,27,4005712,1,3,4.307563701,1,0.333333333,1,0.270277778,4.553999999999999,98.0,2,100.0,0
2512,5175169,7,1,16,29,5150413,11,19,4.333333333,8,0.42105263200000004,1,1.9569444440000001,45.823,118.625,8,72.72727272727273,3
2513,5169990,1,1,16,24,3896331,6,14,4.0,3,0.214285714,1,0.614166667,9.968,80.0,8,50.0,3
2514,5165566,1,1,19,10,4418753,19,72,3.8,17,0.236111111,1,4.508888889,67.014,89.70588235,53,89.47368421052632,2
2515,5164691,5,1,8,51,4538870,1,4,4.0,1,0.25,1,0.850555556,10.969000000000001,209.0,3,100.0,0
2516,5158130,1,1,11,8,4873537,6,8,4.0,5,0.625,1,0.975833333,10.245,60.8,2,83.33333333333334,1
2517,5154026,5,1,10,12,4710254,2,3,5.0,1,0.333333333,1,0.3775,5.647,115.0,1,50.0,1
2518,5141194,3,1,8,21,3677854,2,41,4.0,1,0.024390244,1,0.316666667,6.164,122.0,39,50.0,1
2519,5140430,4,1,21,44,4921870,7,24,4.5,6,0.25,1,1.278055556,31.89,127.83333329999999,17,85.71428571428571,1
2520,5139169,2,1,13,33,5180972,3,7,4.0,2,0.28571428600000004,1,0.485555556,9.976,105.0,4,66.66666666666666,1
2521,5138597,1,1,9,58,4213953,3,9,4.5,3,0.333333333,1,0.46555555600000004,12.357000000000001,89.66666667,6,100.0,0
2522,5133036,2,1,21,4,5378549,7,17,1.0,5,0.294117647,1,1.135555556,18.437,92.0,10,71.42857142857143,2
2523,5132066,3,1,10,48,4038300,4,7,5.0,3,0.428571429,1,0.8422222220000001,12.139000000000001,90.66666667,3,75.0,1
2524,5125607,7,1,12,58,4404466,6,10,5.0,3,0.3,1,1.097777778,26.971,164.66666669999998,4,50.0,3
2525,5124308,3,1,10,29,4677925,1,6,4.307563701,1,0.166666667,1,0.193333333,0.84,45.0,5,100.0,0
2526,5122319,6,1,11,44,3527270,7,15,4.5,6,0.4,1,1.221944444,17.743,82.83333333,8,85.71428571428571,1
2527,5121588,7,1,12,33,5332463,2,11,4.307563701,1,0.090909091,1,0.137222222,1.601,54.0,9,50.0,1
2528,5121283,3,1,14,2,5219079,1,4,4.307563701,1,0.25,1,0.433333333,6.067,121.0,3,100.0,0
2529,5118165,1,1,17,49,5042216,14,48,4.5,11,0.229166667,1,3.4419444439999998,52.887,102.2727273,34,78.57142857142857,3
2530,5117508,5,1,10,27,5074249,4,16,5.0,4,0.25,1,1.309166667,14.747,85.5,12,100.0,0
2531,5115924,2,1,17,8,5233930,2,3,4.307563701,2,0.666666667,1,0.482777778,8.856,102.5,1,100.0,0
2532,5114683,1,1,15,40,5389642,4,5,4.0,1,0.2,1,0.123055556,3.2319999999999998,78.0,1,25.0,3
2533,5114243,1,1,15,53,5162511,2,33,5.0,1,0.03030303,1,0.083333333,2.1630000000000003,62.0,31,50.0,1
2534,5114242,1,1,19,11,4261128,1,44,4.307563701,1,0.022727273,1,0.000555556,0.071,45.0,43,100.0,0
2535,5107420,2,1,15,45,3700014,1,2,4.0,1,0.5,1,0.267777778,4.606,99.0,1,100.0,0
2536,5104490,2,1,12,56,4801770,2,13,5.0,1,0.076923077,1,0.3375,5.072,119.0,11,50.0,1
2537,5099563,1,1,10,13,4314520,10,19,4.2,6,0.31578947399999996,1,2.138055556,33.65,114.83333329999999,9,60.0,4
2538,5097470,2,1,11,20,4851667,3,7,4.5,3,0.428571429,1,0.6880555559999999,10.637,91.33333333,4,100.0,0
2539,5096768,2,1,15,28,4616081,5,6,5.0,4,0.666666667,1,1.237222222,19.881,107.75,1,80.0,1
2540,5086583,5,1,12,11,3060147,2,2,4.0,1,0.5,1,0.5216666670000001,10.644,217.0,0,50.0,1
2541,5082686,2,1,15,24,4380781,8,48,5.0,5,0.10416666699999999,1,1.3780555559999998,19.081,87.4,40,62.5,3
2542,5074255,5,1,10,44,4590349,1,3,3.0,1,0.333333333,1,0.0011111110000000001,0.113,45.0,2,100.0,0
2543,5072441,1,1,14,27,4682746,17,41,4.8888888889999995,15,0.365853659,1,4.801388889,88.70299999999999,119.46666670000002,24,88.23529411764706,2
2544,5072166,5,1,18,44,4034598,2,2,5.0,2,1.0,1,0.265833333,5.313,69.5,0,100.0,0
2545,5070127,3,1,18,24,3962497,1,22,4.0,1,0.045454545,1,0.448611111,9.238,175.0,21,100.0,0
2546,5066786,2,1,18,35,4050862,1,1,5.0,1,1.0,1,0.014722222,0.6779999999999999,45.0,0,100.0,0
2547,5063192,7,1,20,2,5321286,2,16,4.307563701,1,0.0625,1,0.180277778,3.148,77.0,14,50.0,1
2548,5056680,1,1,15,34,4605221,6,121,4.307563701,1,0.008264463,1,0.098055556,2.373,66.0,115,16.666666666666664,5
2549,5054213,1,1,11,54,5377354,6,13,5.0,2,0.153846154,0,0.000277778,0.079,45.0,7,33.33333333333333,4
2550,5052952,1,1,7,36,4806948,5,14,4.0,2,0.14285714300000002,1,0.358055556,10.504000000000001,112.0,9,40.0,3
2551,5052237,1,1,11,16,5075359,8,39,5.0,5,0.128205128,1,2.8883333330000003,35.868,142.6,31,62.5,3
2552,5052203,7,1,19,50,5179772,2,5,4.0,2,0.4,1,0.49166666700000006,6.747999999999999,80.5,3,100.0,0
2553,5045617,4,1,17,17,4646415,6,10,4.307563701,4,0.4,1,0.7675,8.788,69.25,4,66.66666666666666,2
2554,5035367,7,1,18,2,4842677,3,14,4.5,3,0.214285714,1,0.343611111,6.773,64.0,11,100.0,0
2555,5032649,1,1,13,7,3981021,22,23,3.25,14,0.608695652,1,3.4336111110000003,63.864,98.78571429,1,63.63636363636363,8
2556,5031781,3,1,7,34,4371984,12,41,4.25,5,0.12195122,1,0.829722222,15.555,82.2,29,41.66666666666667,7
2557,5019571,3,1,17,19,4399957,1,1,4.307563701,1,1.0,1,0.353055556,4.504,98.0,0,100.0,0
2558,5017542,2,1,10,22,4303138,2,2,4.0,2,1.0,1,0.517777778,7.108,83.0,0,100.0,0
2559,5016045,1,1,6,54,5285636,2,2,5.0,2,1.0,1,0.5641666670000001,13.898,132.0,0,100.0,0
2560,5010738,1,1,11,56,3112913,3,7,4.5,3,0.428571429,1,0.5111111110000001,9.078,75.33333333,4,100.0,0
2561,5007501,7,1,15,46,5424177,3,11,5.0,3,0.272727273,1,1.055277778,26.322,167.0,8,100.0,0
2562,5006393,1,1,12,9,4496058,4,8,4.0,4,0.5,1,0.004722222,2.023,48.0,4,100.0,0
2563,5004526,1,1,13,57,3046474,10,14,4.25,7,0.5,1,1.109166667,16.104,66.85714286,4,70.0,3
2564,5004214,7,1,12,35,3972281,4,10,5.0,4,0.4,1,1.468055556,28.084,139.75,6,100.0,0
2565,5003499,2,1,16,13,3485092,10,14,4.166666667,6,0.428571429,0,1.239444444,18.042,78.66666667,4,60.0,4
2566,5003472,1,1,9,48,4962323,12,14,4.0,8,0.571428571,1,1.855277778,38.239000000000004,101.75,2,66.66666666666666,4
2567,5003305,4,1,16,50,3022907,3,4,4.307563701,2,0.5,1,0.9694444440000001,10.202,111.0,1,66.66666666666666,1
2568,4999922,1,1,6,20,4307623,1,1,4.307563701,1,1.0,1,0.38,6.0329999999999995,114.0,0,100.0,0
2569,4989474,2,1,19,19,3900307,1,2,4.307563701,1,0.5,1,0.131944444,2.253,64.0,1,100.0,0
2570,4986858,2,1,18,54,3998782,1,8,4.0,1,0.125,1,0.359444444,5.85,118.0,7,100.0,0
2571,4985831,4,1,20,4,4381516,4,31,5.0,4,0.129032258,1,0.7375,13.567,94.0,27,100.0,0
2572,4984824,2,1,14,4,5157387,3,3,4.0,3,1.0,1,1.070833333,21.225,136.33333330000002,0,100.0,0
2573,4984820,5,1,8,53,4813454,3,27,4.307563701,1,0.037037037,0,0.7013888890000001,0.131,45.0,24,33.33333333333333,2
2574,4983816,5,1,15,7,5312523,2,21,4.0,1,0.047619048,1,0.211666667,5.332000000000001,110.0,19,50.0,1
2575,4979685,5,1,16,29,5151595,6,15,4.4,5,0.333333333,1,0.594166667,12.078,66.4,9,83.33333333333334,1
2576,4977270,2,1,15,31,4978449,2,9,5.0,1,0.111111111,1,0.386111111,7.381,141.0,7,50.0,1
2577,4971406,4,1,19,41,5324321,3,3,5.0,3,1.0,1,0.565,8.794,76.0,0,100.0,0
2578,4968719,7,1,11,30,5037571,10,42,5.0,2,0.047619048,1,0.44027777799999995,10.306,114.5,32,20.0,8
2579,4965828,3,1,10,8,4624073,2,23,5.0,1,0.043478261,1,0.435555556,6.159,163.0,21,50.0,1
2580,4957886,7,1,12,8,3741634,7,74,5.0,5,0.067567568,1,1.221666667,24.746,109.6,67,71.42857142857143,2
2581,4939558,2,1,17,38,5012761,1,2,4.307563701,1,0.5,1,0.090277778,0.985,45.0,1,100.0,0
2582,4913109,1,1,9,24,4847755,2,2,4.307563701,1,0.5,0,0.267777778,4.127,94.0,0,50.0,1
2583,4912443,2,1,19,4,4942690,1,5,4.307563701,1,0.2,1,0.21,3.676,83.0,4,100.0,0
2584,4904873,2,1,16,50,3774709,3,29,5.0,1,0.034482759,1,0.195833333,2.097,61.0,26,33.33333333333333,2
2585,4887294,7,1,10,41,5438853,1,5,4.307563701,1,0.2,1,0.342777778,8.896,181.0,4,100.0,0
2586,4881584,2,1,11,3,3689842,7,23,5.0,5,0.21739130399999998,1,1.546944444,28.02,113.6,16,71.42857142857143,2
2587,4874716,3,1,7,36,4210074,2,6,4.0,2,0.333333333,1,0.461111111,12.030999999999999,122.5,4,100.0,0
2588,4873073,2,1,13,52,5395953,3,8,4.0,2,0.25,1,0.454166667,7.872000000000001,98.0,5,66.66666666666666,1
2589,4869729,7,1,16,58,3056411,1,4,5.0,1,0.25,1,0.14472222199999998,3.582,84.0,3,100.0,0
2590,4868647,7,1,8,36,4435844,2,9,5.0,2,0.222222222,1,0.575833333,13.329,131.5,7,100.0,0
2591,4868327,1,1,10,48,5034086,1,1,5.0,1,1.0,1,0.16527777800000001,2.701,71.0,0,100.0,0
2592,4868236,2,1,8,58,4795309,2,4,4.0,1,0.25,0,0.210555556,4.671,100.0,2,50.0,1
2593,4867070,1,1,9,25,5361681,3,8,3.0,2,0.25,1,0.383611111,5.746,73.5,5,66.66666666666666,1
2594,4864375,2,1,15,38,4873087,2,5,3.5,2,0.4,1,0.001388889,0.429,45.0,3,100.0,0
2595,4856408,6,1,10,30,5431577,2,10,5.0,1,0.1,1,0.436666667,8.565,174.0,8,50.0,1
2596,4846523,5,1,11,28,4868795,2,9,4.0,1,0.111111111,1,0.7805555559999999,7.416,162.0,7,50.0,1
2597,4845237,1,1,18,9,5236128,6,6,4.307563701,1,0.166666667,0,0.000833333,0.08800000000000001,45.0,0,16.666666666666664,5
2598,4833944,4,1,6,39,5016139,5,19,4.307563701,3,0.15789473699999998,1,0.762222222,12.254000000000001,91.66666667,14,60.0,2
2599,4833765,7,1,6,50,4551991,3,21,3.5,2,0.095238095,1,0.61,9.402000000000001,100.5,18,66.66666666666666,1
2600,4833554,4,1,8,13,3926096,2,3,3.0,2,0.666666667,1,0.6397222220000001,15.876,152.5,1,100.0,0
2601,4829956,7,1,19,9,5442627,6,31,3.0,2,0.064516129,0,0.126111111,3.531,64.0,25,33.33333333333333,4
2602,4827440,4,1,20,8,3536422,6,12,5.0,3,0.25,1,0.801388889,10.512,87.33333333,6,50.0,3
2603,4810999,1,1,9,0,3770238,4,23,4.5,3,0.130434783,1,0.001388889,5.065,65.0,19,75.0,1
2604,4808918,3,1,21,2,5374149,6,15,4.75,5,0.333333333,1,1.1925,20.217,93.6,9,83.33333333333334,1
2605,4805025,3,1,18,8,4810881,1,11,4.307563701,1,0.090909091,1,0.262222222,4.026,110.0,10,100.0,0
2606,4797623,7,1,14,56,4654534,10,26,4.666666667,8,0.307692308,1,1.916111111,21.336,73.25,16,80.0,2
2607,4791254,7,1,18,2,4529205,3,6,5.0,2,0.333333333,1,0.44277777799999996,8.148,91.0,3,66.66666666666666,1
2608,4791174,2,1,16,51,5181984,4,23,4.0,3,0.130434783,1,0.6788888890000001,11.758,89.0,19,75.0,1
2609,4779258,1,1,15,44,5219849,1,14,2.0,1,0.071428571,1,0.0,0.002,45.0,13,100.0,0
2610,4778333,3,1,11,42,5064853,4,15,4.307563701,2,0.133333333,1,0.491944444,8.083,93.5,11,50.0,2
2611,4778251,7,1,18,12,3045788,10,11,4.833333333,10,0.9090909090000001,1,2.002222222,37.91,88.9,1,100.0,0
2612,4777137,3,1,20,14,4242611,3,9,4.307563701,3,0.333333333,1,0.8805555559999999,16.197,112.66666670000001,6,100.0,0
2613,4760860,6,1,13,46,4475427,10,18,5.0,6,0.333333333,1,1.172777778,20.028,86.0,8,60.0,4
2614,4750718,4,1,10,41,4979090,5,9,4.5,5,0.5555555560000001,1,1.470277778,10.232000000000001,82.8,4,100.0,0
2615,4741637,7,1,13,55,5368033,2,22,4.0,1,0.045454545,1,0.18638888899999997,4.729,96.0,20,50.0,1
2616,4740130,7,1,20,0,4739666,3,7,4.0,3,0.428571429,1,0.5825,14.267999999999999,102.66666670000001,4,100.0,0
2617,4711706,4,1,22,47,4953528,4,4,5.0,3,0.75,1,0.706944444,19.576,149.0,0,75.0,1
2618,4703140,1,1,8,44,4709727,6,13,5.0,4,0.307692308,1,1.605833333,30.135,143.0,7,66.66666666666666,2
2619,4693679,1,1,11,11,3802452,4,15,5.0,4,0.26666666699999997,1,1.012777778,13.6,80.25,11,100.0,0
2620,4692622,1,1,11,41,5160259,8,15,5.0,4,0.26666666699999997,1,1.5316666669999999,26.969,143.25,7,50.0,4
2621,4691253,3,1,18,41,3078626,2,9,4.307563701,2,0.222222222,1,0.9966666670000001,16.843,156.5,7,100.0,0
2622,4684299,3,1,20,51,4513270,4,38,5.0,4,0.10526315800000001,1,0.800555556,17.152,94.5,34,100.0,0
2623,4679232,3,1,12,23,5304197,9,43,4.5,3,0.069767442,1,1.229722222,25.139,160.33333330000002,34,33.33333333333333,6
2624,4678338,2,1,20,29,3750327,11,20,4.5,5,0.25,1,1.967777778,24.366,103.6,9,45.45454545454545,6
2625,4677676,2,1,6,54,4938164,1,2,4.307563701,1,0.5,1,0.110833333,2.8930000000000002,73.0,1,100.0,0
2626,4673316,4,1,19,0,3043390,1,1,5.0,1,1.0,1,0.189722222,3.182,98.0,0,100.0,0
2627,4672173,7,1,11,55,5114584,2,13,4.307563701,1,0.076923077,1,0.33833333299999996,6.992000000000001,135.0,11,50.0,1
2628,4671933,3,1,18,25,5360940,1,15,4.307563701,1,0.066666667,1,0.1325,1.879,65.0,14,100.0,0
2629,4649791,1,1,7,54,5020587,2,5,4.0,1,0.2,0,0.196111111,4.078,91.0,3,50.0,1
2630,4645382,1,1,13,10,4505719,3,23,4.307563701,1,0.043478261,0,0.322777778,4.287,94.0,20,33.33333333333333,2
2631,4644128,3,1,10,19,4950907,2,11,5.0,1,0.090909091,1,0.293888889,5.468,133.0,9,50.0,1
2632,4632572,1,1,17,49,3050740,2,14,5.0,1,0.071428571,1,0.225277778,3.1719999999999997,78.0,12,50.0,1
2633,4630383,1,1,11,36,4816888,3,7,5.0,3,0.428571429,1,0.668611111,9.037,79.66666667,4,100.0,0
2634,4627021,5,1,13,31,3779799,1,14,1.0,1,0.071428571,1,1.057777778,8.996,166.0,13,100.0,0
2635,4626859,1,1,18,58,4910767,2,4,4.307563701,1,0.25,0,0.258055556,3.977,90.0,2,50.0,1
2636,4620268,2,1,21,3,5407098,1,1,4.307563701,1,1.0,1,0.052222222,0.578,45.0,0,100.0,0
2637,4618187,2,1,14,50,3791349,1,5,5.0,1,0.2,1,0.106944444,2.003,60.0,4,100.0,0
2638,4606067,2,1,12,37,5110174,14,15,4.333333333,10,0.666666667,1,2.438055556,39.02,95.7,1,71.42857142857143,4
2639,4604762,5,1,9,32,4714547,1,15,4.307563701,1,0.066666667,1,0.4675,8.218,158.0,14,100.0,0
2640,4599002,1,1,16,14,5282247,3,3,4.307563701,1,0.333333333,1,0.468888889,8.22,157.0,0,33.33333333333333,2
2641,4597921,2,1,18,46,5372654,10,19,5.0,1,0.052631579000000005,1,0.173333333,2.358,65.0,9,10.0,9
2642,4583184,2,1,12,29,4107618,1,3,4.0,1,0.333333333,1,0.41944444399999997,6.379,126.0,2,100.0,0
2643,4579381,4,1,14,31,3712670,1,4,4.0,1,0.25,1,0.4225,6.917999999999999,134.0,3,100.0,0
2644,4578396,1,1,17,54,5301991,1,1,4.307563701,1,1.0,1,0.456944444,5.52,113.0,0,100.0,0
2645,4572342,7,1,11,48,4658321,7,21,3.0,7,0.333333333,1,1.731388889,32.188,100.8571429,14,100.0,0
2646,4566126,4,1,17,7,3459922,1,5,5.0,1,0.2,1,0.581666667,11.495999999999999,202.0,4,100.0,0
2647,4553073,1,1,17,48,5157232,9,31,4.5,2,0.064516129,1,3.56,16.009,126.0,22,22.22222222222222,7
2648,4551598,2,1,18,2,4970528,1,2,4.307563701,1,0.5,1,0.24583333300000001,4.361000000000001,95.0,1,100.0,0
2649,4541735,5,1,22,8,5264878,2,9,4.307563701,1,0.111111111,1,0.17944444399999998,4.656000000000001,117.0,7,50.0,1
2650,4540397,3,1,20,12,5202361,1,4,4.307563701,1,0.25,1,0.517777778,9.38,171.0,3,100.0,0
2651,4536703,1,1,10,24,3067181,8,18,4.0,8,0.444444444,1,2.349444444,47.268,119.75,10,100.0,0
2652,4534594,1,1,7,11,4447386,1,17,4.307563701,1,0.058823529000000006,1,0.263055556,6.295,123.0,16,100.0,0
2653,4530279,7,1,15,49,4666328,12,13,4.5,9,0.692307692,1,1.690833333,37.442,93.44444444,1,75.0,3
2654,4529500,2,1,17,0,4712121,2,4,4.307563701,1,0.25,1,0.579444444,8.201,153.0,2,50.0,1
2655,4520568,5,1,11,7,4537984,2,5,4.307563701,1,0.2,0,0.306666667,4.515,98.0,3,50.0,1
2656,4519589,3,1,20,0,3900379,3,22,4.0,1,0.045454545,1,767.5355556,1.775,57.0,19,33.33333333333333,2
2657,4500882,1,1,5,57,5335854,3,13,1.0,2,0.153846154,1,0.423055556,13.526,131.0,10,66.66666666666666,1
2658,4495750,2,1,10,37,3632661,1,10,5.0,1,0.1,1,0.500555556,9.24,174.0,9,100.0,0
2659,4493282,4,1,14,51,4204338,4,4,4.0,3,0.75,1,0.763333333,15.15,106.0,0,75.0,1
2660,4479481,5,1,9,15,4588384,7,17,4.307563701,3,0.176470588,1,0.931111111,11.222000000000001,87.33333333,10,42.857142857142854,4
2661,4473097,1,1,11,41,5058538,3,4,4.307563701,1,0.25,1,0.553888889,10.107000000000001,182.0,1,33.33333333333333,2
2662,4441562,7,1,12,52,4952239,6,27,2.666666667,4,0.148148148,1,0.8019444440000001,15.450999999999999,88.0,21,66.66666666666666,2
2663,4432882,6,1,20,24,5432800,2,11,1.0,1,0.090909091,0,0.000277778,0.062,45.0,9,50.0,1
2664,4423909,1,1,10,32,3338259,1,3,4.307563701,1,0.333333333,1,0.131111111,2.906,74.0,2,100.0,0
2665,4417511,5,1,10,49,4448318,11,30,4.0,11,0.36666666700000006,1,3.846666667,73.77600000000001,134.63636359999998,19,100.0,0
2666,4417366,6,1,21,5,4988359,5,9,4.5,5,0.5555555560000001,1,1.011111111,23.255,107.0,4,100.0,0
2667,4415447,7,1,19,15,5040665,7,18,4.0,4,0.222222222,1,1.044166667,24.065,121.25,11,57.14285714285714,3
2668,4412536,3,1,18,34,3563472,4,8,5.0,3,0.375,1,0.39083333299999995,12.009,90.0,4,75.0,1
2669,4392774,3,1,12,12,5186708,11,27,3.5,7,0.25925925899999996,1,1.28,20.851,80.0,16,63.63636363636363,4
2670,4386339,1,1,9,53,4996675,10,31,3.5,7,0.225806452,1,1.663055556,34.866,106.57142859999999,21,70.0,3
2671,4383608,1,1,11,0,5394976,2,5,4.5,2,0.4,1,1.21,19.449,178.5,3,100.0,0
2672,4367296,5,1,18,0,4896113,1,1,4.307563701,1,1.0,1,0.23694444399999998,5.957999999999999,113.0,0,100.0,0
2673,4361429,2,1,10,43,5210899,1,1,4.307563701,1,1.0,1,0.000833333,5.063,122.0,0,100.0,0
2674,4354743,3,1,14,51,3812693,3,52,3.0,3,0.057692308,1,0.502777778,6.862,69.33333333,49,100.0,0
2675,4350011,1,1,22,7,4582804,9,11,4.666666667,5,0.454545455,1,1.161944444,26.211,120.6,2,55.55555555555556,4
2676,4330693,1,1,15,35,5396484,2,2,5.0,2,1.0,1,0.563888889,12.293,129.0,0,100.0,0
2677,4319875,2,1,19,23,4129104,13,33,4.0,3,0.090909091,1,0.59,9.222999999999999,77.66666667,20,23.076923076923077,10
2678,4315314,7,1,16,24,5297634,7,14,4.0,7,0.5,1,1.690277778,34.684,104.8571429,7,100.0,0
2679,4300879,7,1,11,40,4917363,8,22,4.307563701,5,0.22727272699999998,1,1.071944444,20.415,101.4,14,62.5,3
2680,4293280,1,1,9,2,3659778,7,10,4.666666667,5,0.5,1,1.3586111109999999,23.963,102.0,3,71.42857142857143,2
2681,4291384,1,1,15,2,4269656,7,22,4.5,5,0.22727272699999998,1,1.947222222,32.211,124.6,15,71.42857142857143,2
2682,4286008,5,1,19,52,5136123,1,9,3.0,1,0.111111111,1,0.333611111,6.282,124.0,8,100.0,0
2683,4255170,3,1,7,48,4421959,1,3,5.0,1,0.333333333,1,0.002777778,0.001,45.0,2,100.0,0
2684,4251660,4,1,14,21,4481596,1,2,3.0,1,0.5,1,22.57916667,12.552999999999999,218.0,1,100.0,0
2685,4244812,2,1,7,18,5297111,1,31,5.0,1,0.032258065,1,0.261111111,5.667000000000001,115.0,30,100.0,0
2686,4233451,5,1,16,5,5017268,2,2,5.0,1,0.5,1,0.42222222200000004,8.726,157.0,0,50.0,1
2687,4228535,4,1,11,0,5417680,1,4,4.307563701,1,0.25,1,0.4275,5.787999999999999,117.0,3,100.0,0
2688,4212401,4,1,13,54,5394857,3,11,4.0,2,0.181818182,1,0.453611111,7.5520000000000005,99.0,8,66.66666666666666,1
2689,4210795,5,1,13,36,5191692,2,2,5.0,2,1.0,1,1.045277778,14.017999999999999,143.0,0,100.0,0
2690,4205399,1,1,7,55,4814107,1,1,4.307563701,1,1.0,1,0.000555556,0.19699999999999998,45.0,0,100.0,0
2691,4194105,7,1,20,24,5265440,3,9,4.307563701,3,0.333333333,1,0.7075,13.907,106.66666670000001,6,100.0,0
2692,4192936,1,1,9,43,4854731,4,45,5.0,1,0.022222222000000003,1,0.336944444,6.167999999999999,135.0,41,25.0,3
2693,4187267,4,1,16,19,3966780,1,10,4.307563701,1,0.1,1,0.308611111,4.705,101.0,9,100.0,0
2694,4186691,1,1,22,4,5021715,8,14,4.6,6,0.428571429,1,1.183611111,32.053000000000004,118.33333329999999,6,75.0,2
2695,4183165,7,1,14,49,5009261,5,7,4.333333333,5,0.7142857140000001,1,0.885833333,17.262,88.0,2,100.0,0
2696,4181160,2,1,16,32,4431669,7,10,4.0,3,0.3,1,1.046666667,14.84,105.0,3,42.857142857142854,4
2697,4156948,1,1,18,29,3780287,13,20,3.666666667,7,0.35,1,1.7847222219999999,33.898,106.8571429,7,53.84615384615385,6
2698,4153896,7,1,10,51,4939526,1,17,4.0,1,0.058823529000000006,1,0.286666667,7.75,146.0,16,100.0,0
2699,4148609,6,1,16,16,5089802,1,29,5.0,1,0.034482759,1,0.400277778,5.48,123.0,28,100.0,0
2700,4132858,3,1,13,40,4112602,5,7,5.0,4,0.571428571,1,0.851944444,15.305,87.25,2,80.0,1
2701,4121855,3,1,8,36,4839516,3,8,5.0,1,0.125,1,0.09888888900000001,2.029,60.0,5,33.33333333333333,2
2702,4113664,1,1,19,11,4777589,3,3,4.0,3,1.0,1,0.7222222220000001,11.912,94.33333333,0,100.0,0
2703,4112664,7,1,19,1,3862547,7,17,4.0,2,0.117647059,1,0.425,9.107999999999999,107.5,10,28.57142857142857,5
2704,4102924,6,1,11,23,3453333,1,4,5.0,1,0.25,1,0.399444444,6.88,144.0,3,100.0,0
2705,4102596,2,1,17,57,4613386,1,9,5.0,1,0.111111111,1,0.1075,2.4459999999999997,67.0,8,100.0,0
2706,4095791,1,1,10,6,4516415,2,9,5.0,1,0.111111111,1,0.178055556,2.425,66.0,7,50.0,1
2707,4095784,2,1,9,54,5392954,8,10,3.0,6,0.6,1,1.4858333330000002,24.299,91.5,2,75.0,2
2708,4093764,5,1,11,13,3648388,2,2,4.0,1,0.5,1,0.35194444399999997,4.859,103.0,0,50.0,1
2709,4086354,5,1,17,27,5027870,3,12,1.0,2,0.166666667,1,1.064444444,25.618000000000002,222.0,9,66.66666666666666,1
2710,4067968,1,1,11,26,4023021,8,20,4.307563701,2,0.1,1,0.536388889,10.627,110.0,12,25.0,6
2711,4050117,7,1,13,28,3585134,2,3,4.0,2,0.666666667,1,0.3425,7.752000000000001,86.5,1,100.0,0
2712,4045394,4,1,19,0,3865190,8,17,4.25,7,0.41176470600000004,1,2.185833333,43.933,143.71428569999998,9,87.5,1
2713,4042972,1,1,10,25,5263193,2,36,4.5,2,0.055555556,1,0.446944444,9.147,109.5,34,100.0,0
2714,4042700,2,1,10,13,4801498,6,6,4.666666667,5,0.833333333,1,0.702777778,14.777999999999999,75.4,0,83.33333333333334,1
2715,4040978,3,1,12,27,4375638,1,9,4.307563701,1,0.111111111,1,0.000555556,0.41,45.0,8,100.0,0
2716,4040853,6,1,17,1,4620917,2,26,4.307563701,1,0.038461537999999997,0,0.0,0.067,45.0,24,50.0,1
2717,4040689,1,1,12,35,5318442,6,31,4.0,2,0.064516129,1,0.35361111100000003,8.772,99.5,25,33.33333333333333,4
2718,4033894,2,1,20,7,4168504,3,6,5.0,3,0.5,1,0.531111111,12.243,91.33333333,3,100.0,0
2719,4032416,6,1,11,55,5259985,5,9,5.0,1,0.111111111,1,0.48666666700000005,2.407,66.0,4,20.0,4
2720,4030144,3,1,9,43,3826247,3,11,4.307563701,2,0.181818182,1,1.046666667,1.682,48.0,8,66.66666666666666,1
2721,4027867,3,1,8,42,4100319,5,11,5.0,3,0.272727273,1,1.183888889,24.230999999999998,152.33333330000002,6,60.0,2
2722,4027388,2,1,18,51,3064951,1,3,5.0,1,0.333333333,1,0.549166667,12.47,217.0,2,100.0,0
2723,4020164,2,1,10,35,4937294,3,8,3.5,3,0.375,1,0.7505555559999999,8.821,74.0,5,100.0,0
2724,4013798,7,1,9,50,4898352,25,35,4.454545455,23,0.6571428570000001,1,3.9680555560000004,94.655,92.47826087,10,92.0,2
2725,4012943,4,1,17,15,4895100,1,1,5.0,1,1.0,1,0.20222222199999998,3.54,81.0,0,100.0,0
2726,4008445,1,1,11,31,4192769,1,11,5.0,1,0.090909091,1,0.27055555600000003,5.05,122.0,10,100.0,0
2727,4005819,7,1,19,9,5308399,3,5,4.307563701,1,0.2,1,0.39805555600000003,9.564,173.0,2,33.33333333333333,2
2728,3998260,3,1,13,0,4391825,5,6,5.0,1,0.166666667,1,0.259444444,5.694,115.0,1,20.0,4
2729,3973221,4,1,18,43,4824957,1,1,5.0,1,1.0,1,0.3525,5.829,129.0,0,100.0,0
2730,3962188,4,1,19,24,4709693,3,4,4.0,3,0.75,1,0.794166667,17.865,136.0,1,100.0,0
2731,3960338,3,1,16,56,5312074,3,11,4.307563701,1,0.090909091,0,0.219444444,3.34,80.0,8,33.33333333333333,2
2732,3945720,2,1,19,17,4884720,4,20,5.0,4,0.2,1,1.552777778,28.113000000000003,133.75,16,100.0,0
2733,3944494,6,1,9,14,3532664,1,4,4.0,1,0.25,1,0.898055556,10.588,201.0,3,100.0,0
2734,3938060,7,1,17,19,3969908,4,10,5.0,4,0.4,1,1.304444444,30.363000000000003,143.75,6,100.0,0
2735,3934861,2,1,21,44,3790004,1,1,4.0,1,1.0,1,0.29361111100000004,6.992999999999999,148.0,0,100.0,0
2736,3919989,5,1,16,30,4500073,9,16,5.0,6,0.375,1,2.343611111,35.131,123.83333329999999,7,66.66666666666666,3
2737,3914202,7,1,17,26,5376518,9,15,5.0,5,0.333333333,1,0.957777778,17.259,86.6,6,55.55555555555556,4
2738,3910561,2,1,18,21,3048501,1,11,5.0,1,0.090909091,1,0.35861111100000004,4.632,107.0,10,100.0,0
2739,3907489,7,1,9,33,4577428,4,12,5.0,3,0.25,1,0.6980555559999999,17.792,124.33333329999999,8,75.0,1
2740,3905537,5,1,14,5,5302028,6,12,4.0,4,0.333333333,1,1.4444444440000002,23.78,119.75,6,66.66666666666666,2
2741,3899789,2,1,17,47,5287899,3,15,4.666666667,3,0.2,1,0.7797222220000001,11.972000000000001,102.33333329999999,12,100.0,0
2742,3891358,2,1,13,29,4419794,6,36,4.307563701,1,0.027777778,1,0.19638888899999998,5.232,108.0,30,16.666666666666664,5
2743,3884100,1,1,9,25,3207144,2,19,4.0,1,0.052631579000000005,1,0.0,8.552,158.0,17,50.0,1
2744,3883737,2,1,10,30,4513270,1,20,4.307563701,1,0.05,1,0.4625,6.941,134.0,19,100.0,0
2745,3868681,1,1,18,24,3056266,1,1,5.0,1,1.0,1,0.5116666670000001,8.152999999999999,152.0,0,100.0,0
2746,3827930,3,1,8,32,3911490,4,4,4.0,3,0.75,0,0.520555556,9.625,78.33333333,0,75.0,1
2747,3820817,1,1,10,27,4826519,2,5,4.307563701,1,0.2,0,0.214722222,3.8360000000000003,88.0,3,50.0,1
2748,3812874,1,1,13,0,4146461,3,10,5.0,3,0.3,1,0.638055556,11.805,93.66666667,7,100.0,0
2749,3785380,1,1,12,4,4617101,17,18,4.0,12,0.666666667,1,2.9936111110000003,54.64,102.83333329999999,1,70.58823529411765,5
2750,3754931,7,1,15,34,5244549,6,14,5.0,4,0.28571428600000004,1,0.9975,17.367,95.0,8,66.66666666666666,2
2751,3697004,1,1,11,49,4851715,11,36,4.333333333,5,0.13888888900000002,1,1.640555556,31.171999999999997,130.6,25,45.45454545454545,6
2752,3688728,1,1,11,50,3491120,2,8,4.0,1,0.125,1,0.45805555600000003,6.289,124.0,6,50.0,1
2753,3626282,7,1,17,39,5432084,6,34,4.0,6,0.176470588,1,1.313611111,26.206999999999997,97.83333333,28,100.0,0
2754,3475872,3,1,18,5,4043261,5,23,5.0,4,0.17391304300000002,1,0.478055556,8.474,61.75,18,80.0,1
2755,3475644,3,1,21,2,5158384,5,11,4.307563701,2,0.181818182,1,0.34083333299999996,6.348,87.0,6,40.0,3
2756,3475591,2,1,17,21,4443748,12,24,4.5,7,0.291666667,1,1.9025,29.656999999999996,97.14285714,12,58.333333333333336,5
2757,3439779,1,1,12,15,4980484,2,40,5.0,2,0.05,1,0.748055556,13.050999999999998,128.0,38,100.0,0
2758,3361417,4,1,18,22,4954383,1,19,4.307563701,1,0.052631579000000005,1,0.20027777800000002,3.72,91.0,18,100.0,0
2759,3355609,5,1,15,19,5423840,9,42,5.0,8,0.19047619,1,2.213333333,47.997,123.75,33,88.88888888888889,1
2760,3255380,1,1,11,40,3834388,2,3,5.0,2,0.666666667,1,0.7655555559999999,16.177,151.0,1,100.0,0
2761,3218204,4,1,16,47,4842633,2,6,5.0,2,0.333333333,1,0.568333333,10.587,109.5,4,100.0,0
2762,3207543,3,1,14,44,5063514,9,9,4.75,7,0.7777777779999999,1,1.996388889,38.424,112.42857140000001,0,77.77777777777779,2
2763,3196540,2,1,10,52,4191915,4,14,5.0,2,0.14285714300000002,1,0.39777777799999997,9.815,103.5,10,50.0,2
2764,3086743,2,1,16,54,3415566,4,8,5.0,3,0.375,1,0.5069444439999999,9.186,76.33333333,4,75.0,1
2765,3045120,2,1,17,44,4865011,4,47,5.0,1,0.021276596000000002,1,0.289166667,5.651,115.0,43,25.0,3
2766,3040004,4,1,20,42,4827843,1,17,4.307563701,1,0.058823529000000006,1,0.42722222200000004,0.107,45.0,16,100.0,0
2767,2955278,7,1,17,39,3614667,1,2,4.0,1,0.5,1,0.130555556,1.936,63.0,1,100.0,0
2768,2940018,1,1,10,34,3521338,5,28,4.0,2,0.071428571,1,0.7877777779999999,11.978,127.5,23,40.0,3
2769,2932118,2,1,12,39,5198505,3,7,5.0,2,0.28571428600000004,0,0.278888889,0.13,45.0,4,66.66666666666666,1
2770,2928430,3,1,15,21,5078476,5,10,4.0,2,0.2,1,0.8580555559999999,12.975,133.0,5,40.0,3
2771,2927864,5,1,13,3,5162511,5,6,3.75,5,0.833333333,1,1.215277778,18.579,90.2,1,100.0,0
2772,2927397,7,1,18,7,5442177,1,5,4.307563701,1,0.2,1,0.5775,4.571000000000001,99.0,4,100.0,0
2773,2925573,2,1,21,24,4568992,4,5,4.666666667,4,0.8,1,0.47861111100000003,15.24,99.0,1,100.0,0
2774,2904200,1,1,19,40,4962826,2,6,5.0,1,0.166666667,1,0.29194444399999997,6.225,123.0,4,50.0,1
